,num_parent_commits,merged_from_pull,lines_added,lines_deleted,lines_total,files_total,num_unique_file_formats,combined
0,2,True,186,95,281,10,2,pass
1,1,True,186,95,281,10,2,pass
2,2,True,6,11,17,2,2,pass
3,1,True,6,11,17,2,2,pass
4,2,True,2,2,4,2,1,pass
5,1,True,1,1,2,1,1,fail
6,1,True,1,1,2,1,1,fail
7,2,True,205,71,276,7,2,pass
8,2,True,2,1,3,1,1,pass
9,1,True,2,1,3,1,1,fail
10,1,True,205,71,276,7,2,pass
11,2,True,159,125,284,6,2,pass
12,1,True,2,2,4,1,1,pass
19,2,True,219,127,346,9,2,pass
20,1,True,1,1,2,1,1,pass
21,2,True,0,0,0,0,0,pass
25,1,True,8,1,9,1,1,pass
27,1,False,1,1,2,1,1,pass
28,2,True,1,0,1,1,1,fail
29,1,True,1,0,1,1,1,fail
31,2,True,120,201,321,7,2,pass
65,1,True,1,0,1,1,1,pass
68,2,True,1,0,1,1,1,pass
69,1,True,1,0,1,1,1,pass
70,2,True,200,119,319,6,1,pass
71,2,True,8,8,16,3,2,pass
72,2,True,28136,33,28169,33,12,pass
73,1,True,12,13,25,1,1,pass
74,1,True,2,1,3,1,1,pass
76,2,True,2,2,4,1,1,pass
79,1,True,2,2,4,1,1,pass
80,1,True,2,2,4,1,1,pass
81,2,True,1,0,1,1,1,pass
82,1,True,1,0,1,1,1,fail
83,1,True,28051,0,28051,26,11,fail
84,1,True,28051,0,28051,26,11,fail
85,2,True,20,11,31,2,2,pass
86,2,True,1,1,2,1,1,pass
87,1,True,18,9,27,1,1,fail
88,2,True,1,1,2,1,1,pass
89,1,True,2,2,4,1,1,fail
90,1,True,1,0,1,1,1,pass
91,1,True,1,1,2,1,1,pass
92,1,False,6,0,6,1,1,pass
93,1,False,2,1,3,1,1,fail
94,2,True,50,15,65,2,2,pass
95,2,True,0,0,0,0,0,pass
96,1,True,1,1,2,1,1,pass
98,1,True,6,0,6,1,1,pass
99,1,False,1,1,2,1,1,pass
100,1,False,2,2,4,1,1,pass
101,1,True,3,3,6,1,1,pass
102,1,True,1,1,2,1,1,pass
112,2,True,21,3158,3179,4,2,pass
117,2,True,21,3141,3162,4,2,pass
120,1,True,3,3,6,1,1,pass
121,1,True,18,136,154,1,1,fail
122,1,True,0,3002,3002,1,1,fail
123,1,True,1,1,2,1,1,fail
124,1,True,1,1,2,1,1,fail
125,2,True,270,134,404,8,2,pass
126,2,True,13,0,13,1,1,pass
131,1,True,13,0,13,1,1,pass
132,1,True,1,3,4,1,1,pass
133,1,True,99,51,150,3,1,fail
134,1,True,1,1,2,1,1,pass
135,2,True,1,1,2,1,1,pass
136,1,True,62,29,91,5,2,pass
137,1,True,1,1,2,1,1,pass
138,1,True,28,0,28,2,1,pass
139,1,True,71,55,126,4,2,pass
140,2,True,423,359,782,6,3,fail
141,2,True,3,2,5,2,2,pass
143,2,True,6,2,8,2,2,pass
144,1,True,342,341,683,1,1,pass
145,1,True,0,1,1,1,1,pass
146,1,True,5,1,6,2,1,fail
148,1,True,4,0,4,1,1,pass
149,1,True,2,2,4,1,1,pass
189,2,True,3,1,4,1,1,pass
190,1,True,3,1,4,1,1,pass
191,1,True,1,1,2,1,1,fail
192,2,True,4,4,8,2,1,fail
302,2,True,5,5,10,1,1,pass
303,1,True,5,5,10,1,1,pass
304,2,True,15,11,26,5,4,pass
305,1,True,7,0,7,1,1,pass
306,1,True,1,1,2,1,1,pass
307,1,True,0,4,4,1,1,pass
308,2,True,0,0,0,0,0,fail
310,2,True,0,0,0,0,0,fail
311,1,True,5,1,6,2,2,fail
312,1,True,0,4,4,1,1,pass
313,1,True,2,4,6,1,1,fail
315,1,True,7,5,12,1,1,fail
316,1,True,4,4,8,1,1,fail
317,1,True,4,2,6,1,1,fail
318,1,True,4,4,8,1,1,fail
319,1,True,0,7,7,1,1,fail
320,1,True,12,6,18,1,1,fail
321,2,True,8,1,9,2,2,pass
322,1,True,1,1,2,1,1,fail
323,1,True,7,0,7,1,1,fail
324,2,True,2,1,3,1,1,pass
325,1,True,2,1,3,1,1,pass
327,2,True,36,19,55,4,2,pass
328,1,True,7,0,7,1,1,pass
329,1,True,1,1,2,1,1,pass
330,1,True,15,15,30,1,1,pass
331,1,True,26,16,42,1,1,fail
332,1,True,3,3,6,1,1,fail
333,1,True,1,1,2,1,1,fail
334,1,True,16,16,32,2,1,fail
335,1,True,15,15,30,1,1,fail
336,2,True,113,239,352,11,2,pass
337,1,True,3,1,4,1,1,pass
338,1,True,0,4,4,1,1,pass
339,1,True,20,1,21,2,2,pass
340,2,True,1,1,2,1,1,pass
341,1,True,1,1,2,1,1,pass
342,2,True,7,0,7,1,1,pass
343,1,True,7,0,7,1,1,pass
344,2,True,6,0,6,1,1,pass
345,1,True,1,1,2,1,1,pass
346,1,True,6,0,6,1,1,fail
347,2,True,1,8,9,1,1,pass
348,1,True,1,1,2,1,1,pass
349,2,True,0,1,1,1,1,pass
350,2,True,19,196,215,1,1,fail
351,2,True,25,2,27,3,2,fail
352,2,True,1,1,2,1,1,fail
353,2,True,32,19,51,3,1,pass
354,2,True,4,4,8,2,1,pass
355,2,True,1,1,2,1,1,pass
356,2,True,3,2,5,2,1,fail
357,1,True,1,1,2,1,1,pass
358,1,True,1,1,2,1,1,pass
359,1,True,2,2,4,1,1,pass
362,2,True,2,1,3,1,1,pass
363,1,True,32,19,51,3,1,pass
364,1,True,1,1,2,1,1,pass
365,1,True,1,8,9,1,1,fail
366,1,True,2,1,3,1,1,pass
367,1,True,0,1,1,1,1,pass
368,1,True,15,0,15,1,1,pass
369,1,True,15,10,25,1,1,pass
370,1,True,14,196,210,1,1,fail
371,2,True,51,37,88,9,2,pass
372,1,True,10,2,12,2,2,pass
373,2,True,4,1,5,2,1,pass
374,2,True,5,5,10,1,1,pass
375,1,True,5,5,10,1,1,pass
376,1,True,2,1,3,1,1,pass
377,2,True,14,21,35,1,1,pass
378,2,True,2,4,6,1,1,pass
379,1,True,14,21,35,1,1,pass
380,1,True,2,4,6,1,1,pass
381,1,True,3,1,4,2,1,fail
382,1,True,3,3,6,2,1,pass
383,2,True,12,3,15,1,1,pass
384,1,True,1,2,3,1,1,pass
385,2,True,3,0,3,1,1,pass
386,2,True,1,1,2,1,1,pass
387,1,True,14,4,18,1,1,pass
388,1,True,3,0,3,1,1,pass
389,1,True,10,2,12,2,1,fail
390,1,True,1,1,2,1,1,pass
391,2,True,693,153,846,23,5,pass
392,2,True,34,16,50,3,1,pass
393,1,True,1,1,2,1,1,pass
394,1,True,6,5,11,2,1,pass
395,1,True,28,14,42,2,1,fail
397,2,True,10,11,21,1,1,pass
398,1,True,4,3,7,1,1,pass
399,1,True,1,0,1,1,1,pass
400,2,True,124,107,231,8,1,pass
401,1,True,1,0,1,1,1,pass
402,2,True,443,1,444,5,3,fail
403,1,True,5,5,10,1,1,pass
404,1,True,1,1,2,1,1,pass
405,1,True,2,4,6,1,1,fail
406,1,True,1,1,2,1,1,fail
407,1,True,6,1,7,2,1,fail
410,1,True,1,1,2,1,1,fail
411,1,True,1,0,1,1,1,pass
412,2,True,4,1,5,2,1,pass
413,1,True,1,0,1,1,1,pass
414,2,True,6,3,9,1,1,pass
415,1,True,15,1,16,2,2,pass
416,2,True,12,5,17,3,2,pass
417,1,True,1,1,2,1,1,pass
418,1,True,1,1,2,1,1,pass
419,1,True,0,1,1,1,1,fail
420,1,True,0,15,15,1,1,fail
421,2,True,5,1,6,1,1,pass
422,2,True,23,5,28,3,3,pass
423,2,True,6,1,7,1,1,pass
424,1,True,23,5,28,3,3,pass
425,2,True,11,5,16,1,1,pass
426,2,True,1,1,2,1,1,pass
427,2,True,103,86,189,9,2,pass
428,1,True,1,1,2,1,1,pass
429,1,True,58,23,81,5,1,pass
430,1,True,1,1,2,1,1,pass
431,1,True,8,10,18,1,1,fail
432,1,True,11,5,16,1,1,pass
433,1,True,4,1,5,1,1,pass
434,2,True,2,1,3,1,1,pass
435,1,True,2,1,3,1,1,pass
436,1,True,1,10,11,1,1,pass
437,1,True,1,3,4,1,1,pass
438,1,True,18,18,36,5,1,pass
439,1,True,2,2,4,1,1,pass
440,1,True,37,33,70,3,1,pass
441,1,True,2,1,3,1,1,fail
442,1,True,74,85,159,4,1,fail
443,2,True,6619,5342,11961,39,9,fail
444,1,True,0,3,3,1,1,pass
445,1,True,2,1,3,1,1,fail
446,2,True,7,3,10,2,2,pass
447,1,True,7,3,10,2,2,pass
448,1,True,3,1,4,1,1,pass
449,2,True,7,6,13,4,2,pass
450,1,True,9,4,13,2,1,fail
451,1,True,1,1,2,2,2,pass
452,1,True,7,6,13,3,1,fail
453,2,True,1,1,2,1,1,pass
454,2,True,1,1,2,1,1,pass
455,1,True,1,1,2,1,1,pass
456,1,True,1,1,2,1,1,pass
457,2,True,84,73,157,5,2,pass
458,1,True,2,2,4,1,1,pass
459,1,True,4,2,6,1,1,pass
460,2,True,2,2,4,1,1,fail
461,1,True,7,0,7,1,1,pass
462,1,True,74,96,170,4,2,pass
463,1,True,6,0,6,1,1,fail
464,1,True,4,1,5,1,1,fail
465,2,True,2,2,4,1,1,pass
466,1,True,35,9,44,3,1,fail
467,1,True,2,2,4,1,1,pass
468,1,True,23,0,23,2,2,fail
469,1,True,3,2,5,1,1,fail
471,2,True,42,23,65,6,2,pass
472,2,True,50,30,80,6,2,pass
473,1,True,1,1,2,1,1,pass
474,1,True,0,1,1,1,1,pass
475,1,True,1,3,4,1,1,fail
476,1,True,14,0,14,1,1,fail
477,1,True,5,6,11,2,1,fail
478,1,True,4,0,4,1,1,fail
479,1,True,7,4,11,2,1,fail
480,1,True,2,2,4,1,1,fail
481,1,True,3,3,6,1,1,pass
482,1,True,5,3,8,2,2,pass
483,1,True,1,1,2,1,1,pass
484,1,True,8,7,15,1,1,pass
486,2,True,6593,5352,11945,39,9,pass
487,1,True,1,1,2,1,1,fail
488,1,True,5,5,10,1,1,fail
489,1,True,9,6,15,1,1,fail
490,2,True,150,127,277,3,1,pass
492,2,True,150,127,277,3,1,pass
493,1,True,10,10,20,1,1,fail
494,1,True,0,1,1,1,1,pass
495,1,True,0,1,1,1,1,fail
496,1,True,0,1,1,1,1,fail
497,1,True,31,16,47,1,1,fail
498,1,True,5,0,5,1,1,fail
499,1,True,2,0,2,1,1,fail
500,1,True,40,2,42,1,1,fail
505,1,True,12,11,23,2,1,fail
506,1,True,50,151,201,1,1,fail
507,1,True,1,1,2,1,1,pass
508,1,True,4,2,6,1,1,fail
509,1,True,1,1,2,1,1,pass
510,1,True,18,7,25,2,1,fail
511,1,True,26,11,37,1,1,fail
512,1,True,123,38,161,1,1,fail
513,1,True,11,10,21,1,1,pass
514,1,True,49,13,62,3,1,pass
515,1,True,1,1,2,1,1,pass
516,2,True,3,8,11,1,1,fail
517,1,True,61,84,145,6,2,pass
518,1,True,3,8,11,1,1,fail
520,1,True,3,7,10,2,1,pass
521,1,True,1,3,4,1,1,pass
522,1,True,20,24,44,3,2,fail
523,1,True,1,1,2,1,1,pass
524,1,True,2,14,16,2,1,fail
525,1,True,188,90,278,3,2,pass
526,2,True,18,4,22,2,1,pass
527,2,True,25,1,26,3,2,pass
528,1,True,5,5,10,2,1,pass
529,1,True,1,1,2,1,1,pass
530,1,True,0,2,2,1,1,fail
532,1,True,0,4,4,1,1,fail
534,1,True,4,6,10,2,1,fail
536,1,True,1,1,2,1,1,pass
538,1,True,14,27,41,5,2,fail
540,2,True,5661,4784,10445,29,3,fail
541,1,True,1,3,4,1,1,pass
543,1,True,1,1,2,1,1,fail
544,1,True,5663,4784,10447,29,3,fail
545,2,True,13,18,31,4,1,fail
546,1,True,1,1,2,1,1,pass
547,2,True,34,17,51,1,1,fail
548,1,True,13,18,31,4,1,fail
549,2,True,24,24,48,5,1,fail
550,1,True,1,1,2,1,1,fail
551,1,True,24,24,48,5,1,fail
553,1,True,17,7,24,1,1,pass
556,2,True,2,2,4,1,1,fail
557,2,True,23,4,27,4,2,fail
558,1,True,2,2,4,1,1,pass
559,1,True,1,1,2,1,1,pass
560,1,True,0,4,4,1,1,fail
561,1,True,3,3,6,1,1,fail
562,2,True,5,3,8,1,1,fail
564,1,True,5,5,10,1,1,pass
565,2,True,5,3,8,1,1,fail
566,1,True,8,11,19,3,3,fail
567,1,True,23,4,27,4,2,fail
568,1,True,5,3,8,1,1,fail
569,2,True,275,419,694,14,7,fail
570,2,True,825,442,1267,20,3,fail
571,2,True,578,380,958,14,3,pass
572,2,True,219,60,279,11,2,fail
573,1,True,210,59,269,9,1,pass
574,2,True,28,42,70,2,2,fail
575,1,True,0,2,2,2,2,fail
576,1,True,16,0,16,2,1,fail
577,1,True,1,1,2,1,1,pass
578,2,True,55,9,64,7,2,fail
579,1,True,67,97,164,2,2,fail
580,1,True,9,1,10,2,2,pass
581,1,True,0,1,1,1,1,fail
582,1,True,0,18,18,1,1,fail
583,1,True,5,2,7,2,1,fail
584,1,True,36,20,56,2,2,fail
585,2,True,280,123,403,13,4,fail
586,1,True,19,47,66,2,1,fail
587,1,True,6,10,16,1,1,fail
588,2,True,19,8,27,2,1,pass
589,1,True,12,8,20,2,1,pass
590,1,True,5,1,6,2,2,fail
591,1,True,15,70,85,1,1,pass
592,2,True,27,0,27,3,2,pass
593,1,True,13,6,19,1,1,pass
594,2,True,229,108,337,11,3,pass
595,1,True,1,1,2,1,1,pass
597,2,True,19,0,19,2,1,pass
598,1,True,1,0,1,1,1,fail
599,2,True,59,35,94,5,2,fail
600,2,True,57,36,93,5,2,pass
601,2,True,3,3,6,1,1,fail
602,1,True,3,3,6,1,1,pass
603,1,True,0,0,0,1,1,pass
604,1,True,0,3,3,2,2,fail
605,1,True,1,9,10,4,2,fail
606,1,True,0,2,2,1,1,fail
607,1,True,2,1,3,2,1,fail
608,1,True,1,0,1,1,1,fail
609,1,True,2,2,4,1,1,fail
610,2,True,123,43,166,4,2,fail
614,2,True,123,43,166,4,2,fail
615,1,True,1,1,2,1,1,fail
616,1,True,108,305,413,7,2,fail
617,1,True,1,1,2,1,1,pass
618,1,True,1,1,2,1,1,pass
619,1,True,1,0,1,1,1,pass
620,1,True,1,1,2,1,1,pass
621,1,True,6,9,15,3,2,fail
622,1,True,1,2,3,1,1,fail
625,1,True,0,48,48,1,1,fail
626,1,True,32,21,53,3,2,fail
627,1,True,1,1,2,1,1,pass
628,1,True,56,22,78,4,2,pass
629,1,True,67,20,87,3,1,pass
630,1,True,1,0,1,1,1,fail
631,2,True,424,175,599,15,5,fail
632,1,True,47,161,208,7,4,fail
633,1,True,23,3,26,5,2,pass
634,1,True,5,0,5,1,1,pass
635,1,True,5,1,6,2,2,pass
637,2,True,17,27,44,3,2,fail
638,1,True,1,1,2,1,1,pass
639,1,True,10,23,33,3,2,fail
640,1,True,16,13,29,1,1,fail
641,1,True,1,1,2,1,1,fail
642,1,True,1,4,5,1,1,fail
643,1,True,146,3,149,3,3,fail
644,1,True,1,1,2,1,1,fail
645,2,True,552,147,699,16,5,fail
646,1,True,1,0,1,1,1,fail
647,1,True,3,2,5,1,1,pass
648,1,True,2,3,5,2,1,pass
649,2,True,178,84,262,10,3,fail
650,2,True,179,85,264,10,3,pass
651,1,True,8,8,16,2,1,pass
652,2,True,379,63,442,10,3,fail
653,2,True,214,77,291,5,2,fail
654,2,True,192,54,246,3,2,pass
655,1,True,1,0,1,1,1,pass
656,1,True,4,10,14,1,1,fail
657,1,True,9,15,24,1,1,pass
658,1,True,2,3,5,1,1,fail
659,1,True,19,104,123,7,2,fail
660,1,True,147,0,147,2,2,pass
661,1,True,2,2,4,1,1,pass
662,1,True,2,2,4,1,1,pass
666,2,True,13,8,21,2,1,pass
667,1,True,1,1,2,1,1,pass
668,1,True,158,77,235,8,2,fail
669,1,True,19,6,25,3,3,fail
670,1,True,2,3,5,1,1,pass
671,1,True,5,1,6,1,1,pass
674,1,True,0,3,3,1,1,pass
675,1,True,3,0,3,1,1,fail
676,1,True,2,2,4,1,1,fail
677,1,True,0,1,1,1,1,fail
679,2,True,28,13,41,4,3,pass
680,1,True,0,3,3,1,1,pass
681,1,True,5,5,10,1,1,pass
682,1,True,18,16,34,1,1,pass
685,1,True,11,19,30,1,1,pass
686,1,True,2,1,3,1,1,pass
687,1,True,1,0,1,1,1,pass
688,1,True,6,0,6,1,1,pass
689,1,True,9,10,19,2,1,pass
690,1,True,12,4,16,2,2,pass
691,1,True,10,21,31,2,1,pass
692,1,True,22,8,30,2,1,pass
693,1,True,7,7,14,1,1,pass
695,1,True,24,22,46,2,1,fail
701,1,True,1,1,2,1,1,pass
702,1,True,3,0,3,1,1,fail
703,2,True,164,3,167,4,2,pass
705,1,True,4,14,18,1,1,pass
706,2,True,9,5,14,3,2,pass
708,1,True,18,0,18,1,1,pass
710,1,True,5,22,27,1,1,pass
711,1,True,9,1,10,1,1,fail
716,1,True,4,3,7,1,1,pass
717,1,True,2,2,4,1,1,fail
718,1,True,32,30,62,2,1,fail
721,1,True,5,2,7,1,1,pass
722,1,True,7,3,10,2,2,pass
723,2,True,3,3,6,1,1,pass
724,1,True,3,3,6,1,1,pass
725,1,True,10,10,20,1,1,pass
726,1,True,0,2,2,1,1,pass
727,1,True,1,3,4,2,1,fail
728,2,True,10,15,25,5,3,fail
767,1,True,245,166,411,2,1,pass
768,2,True,16,2,18,4,2,fail
769,1,True,6,1,7,2,2,fail
770,2,True,10,1,11,2,1,pass
771,1,True,4,4,8,1,1,pass
772,1,True,8,0,8,1,1,fail
773,1,True,1,1,2,1,1,pass
774,1,True,1,0,1,1,1,pass
775,2,True,4,1,5,2,2,fail
776,2,True,5,2,7,3,2,pass
778,2,True,7,2,9,3,2,fail
779,1,True,5,0,5,1,1,pass
781,1,True,1,1,2,1,1,pass
782,1,True,1,1,2,1,1,pass
783,2,True,8,3,11,3,2,pass
784,1,True,1,1,2,1,1,pass
786,1,True,2,2,4,1,1,pass
787,2,True,8,3,11,3,2,fail
788,1,True,1,1,2,1,1,pass
789,1,True,5,0,5,1,1,fail
790,1,True,1,1,2,1,1,pass
791,1,True,1,1,2,1,1,fail
792,1,True,3,3,6,1,1,fail
793,1,True,5,5,10,1,1,fail
797,1,True,2,2,4,1,1,pass
798,1,True,2,2,4,1,1,pass
799,2,True,12,0,12,1,1,pass
800,1,True,12,0,12,1,1,pass
801,2,True,80,2,82,3,2,pass
802,1,True,1,1,2,1,1,pass
803,1,True,10,1,11,1,1,fail
804,1,True,5,0,5,1,1,pass
805,2,True,3,1,4,1,1,pass
806,2,True,2,0,2,1,1,fail
807,1,True,64,0,64,1,1,pass
808,1,True,3,1,4,1,1,pass
809,1,True,2,0,2,1,1,pass
810,2,True,782,344,1126,24,5,pass
811,2,True,27,9,36,2,1,pass
812,2,True,26,8,34,2,1,pass
813,1,True,1,1,2,1,1,pass
814,1,True,16,16,32,1,1,pass
815,2,True,1,1,2,1,1,pass
816,1,True,1,1,2,1,1,pass
817,1,True,0,5,5,1,1,pass
820,1,True,1,1,2,1,1,pass
822,1,True,1,0,1,1,1,pass
824,2,True,4,1,5,2,2,pass
825,2,True,712,274,986,19,5,pass
826,1,True,5,0,5,1,1,pass
827,2,True,3,1,4,1,1,pass
830,2,True,3,1,4,2,2,pass
831,1,True,1,0,1,1,1,pass
832,2,True,14,4,18,3,2,pass
833,2,True,14,4,18,3,2,pass
834,1,True,1,1,2,1,1,pass
836,1,True,8,3,11,1,1,pass
837,1,True,2,1,3,1,1,pass
838,2,True,181,63,244,5,2,pass
839,1,True,1,0,1,1,1,pass
840,1,True,4,21,25,1,1,pass
841,2,True,26,3,29,4,2,pass
842,2,True,515,220,735,18,5,pass
844,2,True,42,15,57,3,2,pass
845,1,True,2,4,6,1,1,pass
846,1,True,22,0,22,1,1,pass
847,1,True,4,4,8,2,1,pass
848,1,True,6,6,12,1,1,fail
849,2,True,43,31,74,7,2,fail
850,1,True,2,2,4,1,1,pass
851,1,True,1,1,2,1,1,pass
852,1,True,3,6,9,1,1,pass
856,1,True,1,1,2,1,1,pass
857,2,True,483,194,677,18,5,fail
858,1,True,3,1,4,2,2,pass
859,1,True,1,0,1,1,1,pass
887,1,True,1,1,2,1,1,pass
888,1,True,1,0,1,1,1,pass
889,1,True,174,60,234,3,1,fail
890,1,True,2,1,3,1,1,fail
891,1,True,72,38,110,5,1,fail
892,2,True,2,2,4,1,1,pass
893,1,True,2,2,4,1,1,pass
894,1,True,2,2,4,1,1,fail
895,1,True,15,11,26,1,1,fail
896,2,True,448,174,622,14,2,fail
897,1,True,3,0,3,1,1,pass
898,2,True,75,11,86,2,1,pass
899,1,True,3,3,6,1,1,pass
900,2,True,439,227,666,18,5,pass
901,2,True,74,63,137,4,2,pass
902,2,True,74,62,136,3,2,pass
903,1,True,1,1,2,1,1,pass
904,1,True,5,0,5,1,1,pass
905,2,True,299,102,401,12,2,pass
906,2,True,58,66,124,6,5,pass
908,1,True,67,102,169,2,1,pass
909,1,True,6,15,21,3,2,pass
910,2,True,0,1,1,1,1,pass
911,1,True,0,1,1,1,1,pass
912,1,True,68,61,129,1,1,pass
913,1,True,4,4,8,2,1,fail
914,1,True,26,28,54,2,1,fail
915,1,True,12,13,25,1,1,pass
916,1,True,62,62,124,2,1,fail
917,1,True,1,6,7,2,2,fail
920,1,True,2,2,4,1,1,pass
921,1,True,71,13,84,2,1,pass
922,2,True,111,57,168,9,4,fail
923,2,True,4,26,30,4,3,pass
924,2,True,104,57,161,8,4,pass
926,2,True,60,40,100,4,3,pass
927,1,True,5,0,5,1,1,pass
928,1,True,55,40,95,3,3,pass
929,2,True,36,3,39,5,2,pass
930,2,True,15,16,31,3,3,pass
931,2,True,12,14,26,3,3,pass
932,1,True,1,1,2,1,1,pass
933,1,True,2,2,4,1,1,pass
934,1,True,19,0,19,1,1,pass
938,1,True,3,2,5,1,1,pass
939,1,True,7,28,35,1,1,pass
940,2,True,2855,5200,8055,36,10,pass
943,2,True,2912,5232,8144,39,10,fail
944,2,True,2855,5200,8055,36,10,pass
945,2,True,2855,5200,8055,36,10,pass
946,1,True,30,28,58,1,1,pass
947,1,True,1,0,1,1,1,fail
948,1,True,2,2,4,2,2,fail
949,1,True,2,1,3,2,2,pass
950,1,True,0,15,15,1,1,pass
951,1,True,1,11,12,1,1,fail
952,1,True,5,1,6,2,2,pass
953,1,True,11,10,21,4,2,pass
954,1,True,24,3,27,4,2,pass
955,1,True,2806,2920,5726,3,1,pass
956,1,True,1,1218,1219,15,2,pass
959,1,True,1,1,2,1,1,fail
960,1,True,4,4,8,1,1,pass
961,1,True,25,7,32,4,3,pass
962,1,True,60,56,116,1,1,pass
963,1,True,1,1,2,1,1,pass
964,1,True,7,0,7,2,2,pass
965,1,True,6,0,6,2,2,pass
966,1,True,22,1,23,2,2,pass
967,1,True,4,21,25,3,1,pass
968,1,True,6,10,16,1,1,pass
969,2,True,6,3,9,2,2,pass
970,1,True,1,1,2,1,1,pass
971,1,True,5,2,7,1,1,pass
972,1,True,1,1,2,1,1,pass
973,1,True,9,9,18,3,1,pass
974,1,True,2,3,5,2,1,pass
975,2,True,890,156,1046,13,3,pass
976,2,True,4,4,8,4,3,fail
977,1,True,2,2,4,2,2,pass
978,1,True,1,1,2,1,1,pass
979,1,True,1,1,2,1,1,pass
980,2,True,341,75,416,7,2,pass
981,1,True,143,21,164,5,2,pass
982,2,True,156,19,175,3,2,pass
983,2,True,42,35,77,2,2,pass
984,1,True,42,35,77,2,2,pass
985,1,True,1,0,1,1,1,pass
986,1,True,16,8,24,1,1,pass
987,1,True,3,1,4,1,1,pass
988,1,True,3,1,4,1,1,fail
989,1,True,6,3,9,1,1,fail
990,1,True,55,3,58,3,2,fail
991,2,True,576,85,661,11,3,fail
992,1,True,38,2,40,1,1,pass
993,2,True,934,456,1390,23,5,pass
994,1,True,1,0,1,1,1,pass
995,1,True,27,8,35,3,1,pass
996,1,True,1,1,2,1,1,pass
997,1,True,262,1,263,6,2,pass
1004,1,True,21,6,27,3,2,pass
1005,1,True,1,1,2,1,1,pass
1006,1,True,11,24,35,1,1,fail
1007,1,True,39,24,63,1,1,pass
1008,2,True,91,0,91,6,2,pass
1009,1,True,0,1,1,1,1,pass
1010,1,True,13,5,18,3,1,pass
1011,2,True,138,150,288,3,3,fail
1012,1,True,13,5,18,1,1,pass
1013,1,True,1,1,2,1,1,pass
1015,1,True,7,2,9,3,3,pass
1016,1,True,1,26,27,2,2,pass
1017,2,True,119,119,238,1,1,fail
1018,1,True,4,4,8,1,1,fail
1019,1,True,1,1,2,1,1,pass
1020,1,True,6,1,7,2,2,pass
1021,1,True,9,3,12,1,1,pass
1022,1,True,1,0,1,1,1,pass
1023,1,True,96,96,192,1,1,fail
1024,1,True,19,19,38,1,1,fail
1025,2,True,1,1,2,1,1,pass
1026,1,True,1,1,2,1,1,pass
1027,2,True,366,388,754,16,4,fail
1028,1,True,1,1,2,1,1,pass
1029,1,True,14,0,14,1,1,pass
1030,1,True,109,0,109,2,2,pass
1031,1,True,1,0,1,1,1,pass
1032,1,True,18,9,27,1,1,pass
1033,1,True,53,0,53,3,2,pass
1034,1,True,3,2,5,1,1,pass
1035,1,True,11,3,14,3,2,pass
1036,1,True,6,319,325,9,4,pass
1037,1,True,24,16,40,5,2,pass
1038,1,True,73,8,81,4,2,pass
1039,1,True,0,21,21,1,1,pass
1040,1,True,29,20,49,2,1,pass
1041,1,True,55,13,68,1,1,pass
1042,1,True,4,0,4,1,1,pass
1043,1,True,58,0,58,1,1,pass
1044,2,True,19,14,33,1,1,pass
1045,1,True,1,0,1,1,1,pass
1046,2,True,18,14,32,1,1,pass
1047,1,True,1,1,2,1,1,pass
1048,1,True,9,12,21,1,1,pass
1049,1,True,16,9,25,1,1,pass
1050,2,True,3,2,5,2,2,pass
1051,2,True,48,31,79,4,2,pass
1052,1,True,8,3,11,2,2,pass
1053,2,True,4,3,7,2,2,pass
1054,2,True,39,24,63,2,2,pass
1055,2,True,39,24,63,2,2,pass
1056,2,True,6,5,11,2,2,pass
1057,1,True,5,0,5,1,1,fail
1058,2,True,5,4,9,2,2,pass
1060,1,True,5,1,6,1,1,pass
1062,1,True,1,1,2,1,1,pass
1064,1,True,13,2,15,1,1,pass
1066,2,True,0,94,94,2,2,pass
1067,1,True,0,59,59,1,1,pass
1068,1,True,0,35,35,1,1,pass
1069,2,True,2,4,6,1,1,pass
1070,1,True,26,23,49,1,1,pass
1071,1,True,2,4,6,1,1,pass
1072,2,True,1,1,2,1,1,pass
1073,1,True,1,1,2,1,1,pass
1074,2,True,5,92,97,3,1,pass
1075,1,True,1,1,2,1,1,pass
1076,2,True,1,2,3,1,1,pass
1077,2,True,1,1,2,1,1,pass
1078,1,True,1,1,2,1,1,pass
1079,2,True,31,4,35,2,2,fail
1080,1,True,1,1,2,1,1,pass
1081,2,True,1,1,2,1,1,pass
1082,1,True,1,1,2,1,1,pass
1083,1,True,11,1,12,1,1,pass
1084,1,True,20,4,24,1,1,pass
1086,1,True,1,2,3,1,1,pass
1087,1,True,0,2,2,1,1,pass
1088,2,True,5,2,7,3,2,pass
1089,1,True,1,1,2,1,1,pass
1090,1,True,3,0,3,1,1,pass
1091,1,True,1,1,2,1,1,pass
1092,1,True,0,79,79,1,1,pass
1093,1,True,4,10,14,1,1,pass
1094,2,True,1416,423,1839,39,14,pass
1095,1,True,4,2,6,1,1,pass
1098,1,True,1,1,2,1,1,pass
1099,1,True,11,8,19,1,1,pass
1100,2,True,326,55,381,4,2,pass
1101,2,True,9,35,44,2,2,pass
1102,2,True,6,33,39,1,1,pass
1103,1,True,6,33,39,1,1,pass
1104,2,True,2,2,4,1,1,pass
1106,1,True,2,2,4,1,1,pass
1107,1,True,207,35,242,1,1,pass
1112,2,True,3,2,5,1,1,pass
1113,1,True,3,2,5,1,1,pass
1115,2,True,13,12,25,2,1,pass
1116,2,True,12,11,23,1,1,pass
1117,1,True,3,3,6,1,1,pass
1118,1,True,9,8,17,1,1,pass
1120,2,True,1,1,2,1,1,pass
1121,1,True,1,1,2,1,1,pass
1122,2,True,1,1,2,1,1,pass
1123,1,True,1,1,2,1,1,pass
1125,1,True,29,29,58,1,1,pass
1126,1,True,149,145,294,1,1,pass
1127,2,True,85,76,161,1,1,pass
1128,2,True,85,76,161,1,1,pass
1129,1,True,85,76,161,1,1,pass
1130,2,True,33,18,51,3,2,pass
1131,2,True,44,33,77,5,3,pass
1132,1,True,1,1,2,1,1,pass
1133,1,True,3,1,4,1,1,fail
1134,1,True,1,7,8,1,1,pass
1135,1,True,33,18,51,3,2,pass
1136,1,True,9,5,14,1,1,pass
1137,1,True,2,1,3,1,1,pass
1138,1,True,1,0,1,1,1,pass
1142,2,True,10,0,10,1,1,pass
1143,1,True,10,0,10,1,1,pass
1144,2,True,1015,329,1344,38,14,pass
1145,1,True,5,3,8,1,1,pass
1146,2,True,6,6,12,1,1,pass
1147,1,True,0,1,1,1,1,pass
1148,1,True,403,38,441,1,1,pass
1150,2,True,6,6,12,1,1,pass
1151,1,True,6,6,12,1,1,pass
1152,2,True,218,105,323,6,2,pass
1153,2,True,194,105,299,5,2,pass
1155,1,True,2,2,4,1,1,pass
1156,1,True,0,1,1,1,1,pass
1157,1,True,0,1,1,1,1,fail
1158,1,True,10,1,11,1,1,fail
1169,1,True,24,0,24,1,1,pass
1170,1,True,0,1,1,1,1,pass
1172,2,True,88,42,130,8,4,pass
1173,1,True,20,5,25,3,3,pass
1174,1,True,62,36,98,4,2,pass
1175,1,True,1,1,2,1,1,pass
1176,1,True,1,1,2,1,1,pass
1177,2,True,6,1,7,2,2,pass
1178,2,True,63,12,75,5,4,pass
1179,1,True,6,1,7,2,2,pass
1180,1,True,6,0,6,1,1,pass
1181,1,True,25,7,32,2,2,pass
1182,1,True,31,2,33,1,1,pass
1183,2,True,1,1,2,1,1,pass
1184,1,True,1,1,2,1,1,pass
1185,2,True,6,2,8,2,2,pass
1186,1,True,4,0,4,1,1,pass
1187,1,True,2,2,4,1,1,pass
1188,1,True,92,17,109,4,3,pass
1207,2,True,10,8,18,3,3,pass
1208,1,True,4,0,4,1,1,pass
1209,1,True,6,8,14,2,2,pass
1210,2,True,7,1,8,1,1,pass
1211,2,True,80,69,149,2,1,pass
1212,1,True,17,17,34,1,1,pass
1213,1,True,7,1,8,1,1,pass
1214,1,True,1,1,2,1,1,pass
1215,1,True,26,22,48,1,1,pass
1217,2,True,92,0,92,4,2,pass
1218,1,True,4,0,4,1,1,pass
1219,1,True,88,0,88,3,2,pass
1220,2,True,1,1,2,1,1,pass
1221,1,True,1,1,2,1,1,pass
1222,2,True,4,0,4,1,1,pass
1223,1,True,4,0,4,1,1,pass
1224,2,True,1,1,2,1,1,pass
1225,1,True,1,1,2,1,1,pass
1226,2,True,5,1,6,2,1,pass
1227,2,True,9,5,14,1,1,fail
1228,1,True,4,0,4,1,1,pass
1229,1,True,9,5,14,1,1,pass
1230,1,True,1,1,2,1,1,pass
1231,2,True,7,1,8,1,1,pass
1232,1,True,7,1,8,1,1,pass
1233,1,True,8,4,12,1,1,pass
1234,2,True,4,0,4,1,1,pass
1235,2,True,5,0,5,2,2,pass
1236,2,True,4,0,4,2,2,pass
1237,1,True,3,0,3,1,1,pass
1238,1,True,3,0,3,1,1,pass
1239,1,True,1,0,1,1,1,pass
1240,2,True,3237,2253,5490,34,1,pass
1241,1,True,240,279,519,15,1,pass
1242,1,True,2,2,4,1,1,pass
1243,1,True,12,14,26,1,1,pass
1244,1,True,55,27,82,3,1,pass
1245,1,True,327,151,478,13,1,pass
1264,2,True,89,39,128,7,2,pass
1265,2,True,9,2,11,1,1,pass
1266,1,True,9,2,11,1,1,pass
1267,2,True,1,0,1,1,1,pass
1268,1,True,1,0,1,1,1,pass
1269,1,True,6,6,12,1,1,pass
1272,1,True,246,285,531,14,1,pass
1273,2,True,42,5,47,4,1,pass
1274,1,True,1,1,2,1,1,pass
1275,1,True,5,1,6,1,1,pass
1276,2,True,21,16,37,1,1,pass
1277,1,True,20,22,42,1,1,pass
1279,1,True,19,2,21,1,1,pass
1280,1,True,40,52,92,1,1,pass
1297,1,True,18,2,20,3,1,pass
1299,1,True,45,17,62,3,1,pass
1300,2,True,220,138,358,3,1,pass
1301,2,True,381,171,552,14,3,pass
1302,1,True,1,2,3,1,1,pass
1303,1,True,9,6,15,1,1,pass
1304,2,True,305,158,463,9,2,pass
1305,1,True,1,1,2,1,1,pass
1306,2,True,75,14,89,7,3,pass
1307,2,True,75,14,89,6,3,pass
1308,2,True,14,16,30,6,3,pass
1311,1,True,2,1,3,1,1,pass
1312,1,True,0,7,7,1,1,fail
1313,1,True,1,0,1,1,1,fail
1314,1,True,1,0,1,1,1,pass
1315,1,True,0,1,1,1,1,pass
1316,1,True,12,6,18,2,2,fail
1317,1,True,1,1,2,1,1,fail
1318,1,True,1,1,2,1,1,fail
1319,1,True,215,131,346,3,1,fail
1320,1,True,5,5,10,1,1,pass
1321,1,True,5,5,10,2,1,pass
1323,2,True,453,82,535,27,5,pass
1324,1,True,6,14,20,1,1,pass
1325,1,True,2,1,3,2,2,pass
1326,2,True,5,1,6,2,2,pass
1327,1,True,4,0,4,1,1,pass
1328,1,True,1,1,2,1,1,pass
1329,1,True,88,14,102,5,2,pass
1330,2,True,0,0,0,13,1,pass
1331,2,True,77,42,119,5,2,pass
1332,1,True,0,0,0,13,1,pass
1333,1,True,5,0,5,1,1,pass
1334,1,True,3,2,5,1,1,pass
1335,1,True,1,1,2,1,1,pass
1336,1,True,1,1,2,1,1,fail
1337,1,True,68,39,107,4,1,fail
1338,2,True,225,3,228,6,4,pass
1339,2,True,123,11,134,6,2,pass
1340,2,True,14,3,17,2,2,pass
1342,2,True,119,18,137,8,2,pass
1344,1,True,3,3,6,1,1,pass
1345,2,True,4,0,4,1,1,pass
1346,1,True,4,0,4,1,1,pass
1347,2,True,1,1,2,1,1,pass
1348,1,True,1,1,2,1,1,pass
1349,2,True,7,0,7,2,2,pass
1350,2,True,97,7,104,4,2,pass
1352,1,True,4,0,4,1,1,pass
1353,1,True,3,0,3,1,1,pass
1354,1,True,70,1,71,3,2,pass
1355,2,True,98,7,105,4,2,pass
1356,1,True,1,1,2,1,1,pass
1357,1,True,1,2,3,2,2,pass
1358,1,True,7,0,7,1,1,pass
1360,1,True,1,1,2,1,1,pass
1361,1,True,4,0,4,1,1,pass
1362,1,True,11,0,11,1,1,pass
1363,1,True,7,5,12,1,1,pass
1365,2,True,1,1,2,1,1,pass
1366,1,True,1,1,2,1,1,pass
1367,2,True,5,6,11,1,1,pass
1368,2,True,2,3,5,1,1,pass
1369,1,True,2,3,5,1,1,pass
1370,1,True,5,6,11,1,1,pass
1371,1,True,40,6,46,1,1,pass
1382,1,True,9,3,12,1,1,pass
1383,2,True,2717,849,3566,13,3,pass
1384,2,True,4,0,4,1,1,pass
1385,1,True,4,0,4,1,1,pass
1386,2,True,2,2,4,2,2,pass
1387,1,True,1,1,2,1,1,pass
1388,1,True,1,1,2,1,1,pass
1389,1,True,2,0,2,1,1,pass
1390,1,True,2,2,4,1,1,pass
1391,1,True,3,3,6,2,2,pass
1392,1,True,1124,828,1952,9,1,pass
1393,2,True,6,2,8,1,1,pass
1394,1,True,6,2,8,1,1,pass
1395,2,True,12,1,13,3,2,pass
1396,1,True,4,0,4,1,1,pass
1397,1,True,1,1,2,1,1,pass
1398,2,True,5,1,6,1,1,pass
1399,1,True,5,1,6,1,1,pass
1400,2,True,1,1,2,1,1,pass
1401,1,True,1,1,2,1,1,pass
1402,1,True,2,2,4,1,1,pass
1407,2,True,2,0,2,1,1,pass
1408,2,True,2,0,2,1,1,pass
1409,1,True,132,0,132,1,1,pass
1414,2,True,19,14,33,4,3,pass
1415,1,True,7,0,7,1,1,pass
1416,1,True,2,0,2,1,1,pass
1417,2,True,1,0,1,1,1,pass
1418,1,True,1,0,1,1,1,pass
1419,2,True,14,16,30,2,2,pass
1420,1,True,3,0,3,1,1,pass
1421,1,True,11,16,27,1,1,pass
1422,2,True,2,1,3,1,1,pass
1423,1,True,2,1,3,1,1,pass
1424,1,True,8,4,12,2,1,pass
1425,1,True,18,18,36,1,1,fail
1440,2,True,186,175,361,22,4,fail
1441,2,True,57,0,57,1,1,pass
1442,1,True,57,0,57,1,1,pass
1443,1,True,8,8,16,1,1,pass
1444,2,True,5,1,6,1,1,fail
1445,1,False,1,1,2,1,1,fail
1446,2,True,14,13,27,6,1,pass
1447,1,True,18,10,28,1,1,pass
1448,1,True,7,7,14,4,1,pass
1450,1,True,1,1,2,1,1,pass
1451,1,True,5,1,6,1,1,pass
1452,1,True,26,73,99,11,1,pass
1453,1,True,58,76,134,5,1,pass
1454,2,True,8,7,15,1,1,pass
1455,2,True,11,7,18,1,1,pass
1456,1,True,6,6,12,1,1,pass
1457,1,True,11,7,18,1,1,fail
1458,1,True,10,7,17,1,1,pass
1460,1,True,2,2,4,1,1,pass
1461,2,True,48,32,80,6,2,fail
1462,2,True,11,3,14,2,2,pass
1463,2,True,427,57,484,7,2,pass
1465,1,True,2,17,19,1,1,pass
1466,2,True,8,0,8,1,1,pass
1467,1,True,8,0,8,1,1,pass
1468,2,True,29,23,52,4,2,pass
1469,1,True,5,0,5,1,1,pass
1489,2,True,2,2,4,1,1,pass
1490,1,True,2,2,4,1,1,pass
1491,2,True,9,3,12,1,1,pass
1492,1,True,9,3,12,1,1,pass
1493,1,True,1,1,2,1,1,pass
1494,1,True,1,1,2,1,1,pass
1495,1,True,1,0,1,1,1,pass
1496,1,True,23,23,46,3,1,fail
1497,2,True,99,23,122,4,2,pass
1498,1,True,1,1,2,1,1,pass
1499,1,True,1,0,1,1,1,pass
1504,2,True,287,1,288,4,2,pass
1505,2,True,1751,542,2293,25,2,pass
1507,2,True,10,13,23,1,1,pass
1508,1,True,10,13,23,1,1,pass
1509,1,True,9,3,12,1,1,pass
1510,2,True,3,2,5,2,2,pass
1511,1,True,3,2,5,2,2,pass
1512,2,True,3,3,6,1,1,pass
1513,1,True,3,3,6,1,1,pass
1514,2,True,1431,224,1655,22,2,pass
1515,1,True,1,1,2,1,1,pass
1516,2,True,161,186,347,4,2,pass
1517,2,True,1,1,2,1,1,pass
1518,2,True,5,4,9,2,1,pass
1519,2,True,20,10,30,1,1,pass
1520,2,True,2,0,2,1,1,pass
1521,1,True,20,10,30,1,1,pass
1522,1,True,5,4,9,2,1,pass
1523,1,True,2,0,2,1,1,pass
1524,1,True,64,6,70,4,2,pass
1525,1,True,1,1,2,1,1,pass
1526,2,True,1,0,1,1,1,fail
1527,2,True,132,171,303,2,1,fail
1528,1,True,7,4,11,2,2,pass
1529,1,True,839,8,847,15,2,pass
1546,2,True,102,55,157,4,2,pass
1547,1,True,1,1,2,1,1,pass
1548,1,True,1,0,1,1,1,pass
1550,1,True,102,55,157,4,2,pass
1551,1,True,132,171,303,2,1,pass
1552,2,True,2,34,36,1,1,pass
1553,1,True,2,34,36,1,1,pass
1554,2,True,63,46,109,3,1,pass
1555,1,True,1,1,2,1,1,pass
1556,1,True,62,45,107,3,1,fail
1557,2,True,8,1,9,1,1,pass
1558,2,True,34,12,46,3,2,pass
1559,1,True,1,1,2,1,1,pass
1560,1,True,16,12,28,2,2,pass
1562,1,True,5,0,5,1,1,pass
1565,2,True,13,0,13,1,1,pass
1566,2,True,1,1,2,1,1,pass
1567,2,True,372,157,529,3,2,pass
1568,1,True,8,1,9,1,1,pass
1569,1,True,11,7,18,1,1,pass
1570,1,True,4,2,6,1,1,pass
1580,1,True,9,0,9,1,1,pass
1581,2,True,17,4,21,1,1,pass
1582,2,True,91,80,171,4,3,pass
1583,2,True,0,0,0,0,0,pass
1584,2,True,1,1,2,1,1,pass
1585,1,True,17,4,21,1,1,fail
1586,2,True,3,3,6,1,1,pass
1587,2,True,121,153,274,1,1,pass
1588,1,True,3,3,6,1,1,pass
1589,1,True,7,2,9,1,1,pass
1590,1,True,19,6,25,3,2,pass
1591,1,True,121,153,274,1,1,pass
1592,2,True,39,28,67,1,1,pass
1593,1,True,39,28,67,1,1,pass
1594,1,True,72,79,151,4,3,pass
1595,2,True,33,0,33,1,1,pass
1596,1,True,33,0,33,1,1,pass
1597,1,True,1,1,2,1,1,pass
1598,2,True,3,0,3,1,1,pass
1599,1,True,3,0,3,1,1,pass
1600,2,True,5,4,9,1,1,pass
1601,2,True,25,27,52,5,1,pass
1602,1,True,1,1,2,1,1,pass
1603,1,True,3,3,6,1,1,pass
1608,2,True,976,904,1880,5,2,pass
1609,2,True,975,906,1881,4,2,pass
1610,1,True,11,11,22,1,1,pass
1611,1,False,2,0,2,1,1,pass
1612,1,True,3,3,6,1,1,pass
1614,1,True,1,0,1,1,1,pass
1615,1,True,43,291,334,1,1,fail
1616,1,True,1,1,2,1,1,pass
1617,1,True,82,8,90,3,2,pass
1618,1,True,1,2,3,1,1,pass
1619,1,True,0,1,1,1,1,pass
1620,1,True,4,2,6,1,1,pass
1621,1,True,5,2,7,1,1,pass
1622,1,True,1,1,2,1,1,pass
1623,1,True,1,1,2,1,1,pass
1624,1,True,4,7,11,1,1,pass
1625,1,True,171,163,334,1,1,pass
1626,1,True,1,1,2,1,1,pass
1627,1,True,2,1,3,1,1,pass
1628,1,True,15,7,22,1,1,pass
1629,1,True,14,7,21,1,1,pass
1630,1,True,13,13,26,1,1,pass
1631,1,True,55,1,56,1,1,pass
1632,1,True,26,47,73,1,1,pass
1636,2,True,4,0,4,1,1,pass
1637,1,True,2,2,4,1,1,pass
1639,1,True,10,4,14,2,1,pass
1640,2,True,4,0,4,1,1,pass
1641,1,True,4,0,4,1,1,pass
1642,1,False,0,0,0,1,1,pass
1643,1,False,0,0,0,1,1,pass
1644,1,False,0,0,0,1,1,fail
1645,2,True,81,350,431,11,2,pass
1646,1,True,2,1,3,1,1,pass
1647,1,True,12,2,14,1,1,pass
1648,1,True,9,0,9,1,1,pass
1649,1,True,59,348,407,9,1,pass
1650,1,False,2,2,4,1,1,pass
1651,2,True,1,1,2,1,1,pass
1652,2,True,26,23,49,1,1,pass
1653,1,True,26,23,49,1,1,pass
1654,2,True,56,44,100,3,1,pass
1655,2,True,3,5,8,1,1,pass
1656,1,True,3,5,8,1,1,pass
1657,1,True,1,1,2,1,1,pass
1658,1,True,1,1,2,1,1,pass
1659,1,True,5,17,22,1,1,pass
1660,2,True,18,11,29,1,1,pass
1661,1,True,17,20,37,1,1,pass
1662,1,True,11,5,16,1,1,pass
1663,1,True,34,42,76,1,1,pass
1665,2,True,48,6,54,3,2,pass
1666,2,True,9,0,9,1,1,pass
1667,2,True,266,76,342,7,1,pass
1668,1,True,15,3,18,1,1,pass
1669,1,True,1,1,2,1,1,pass
1670,1,True,1,1,2,1,1,pass
1671,2,True,0,670,670,1,1,pass
1672,1,True,0,670,670,1,1,pass
1673,2,True,0,39,39,1,1,pass
1674,1,False,1,1,2,1,1,pass
1675,2,True,1,2,3,1,1,pass
1676,1,True,9,0,9,1,1,pass
1677,1,True,1,2,3,1,1,pass
1678,1,True,0,39,39,1,1,pass
1679,1,True,19,16,35,2,1,pass
1680,1,True,6,1,7,2,1,pass
1681,1,True,4,4,8,1,1,pass
1682,2,True,15,1,16,1,1,pass
1683,1,True,11,3,14,1,1,pass
1684,1,True,9,9,18,1,1,pass
1685,1,True,31,4,35,2,1,pass
1686,2,True,15,1,16,1,1,pass
1687,1,True,6,1,7,1,1,pass
1688,1,True,3,3,6,1,1,pass
1689,1,True,30,0,30,1,1,pass
1703,1,True,15,1,16,1,1,pass
1704,2,True,8,0,8,1,1,pass
1705,1,True,8,0,8,1,1,pass
1706,2,True,357,106,463,10,1,pass
1707,2,True,1,1,2,1,1,pass
1708,1,True,1,1,2,1,1,pass
1709,1,True,7,3,10,1,1,pass
1710,2,True,2,2,4,1,1,pass
1711,1,True,2,2,4,1,1,pass
1712,2,True,60,34,94,2,1,pass
1713,2,True,1,1,2,1,1,pass
1714,1,True,357,106,463,10,1,pass
1715,2,True,3,1,4,1,1,pass
1716,1,True,0,1,1,1,1,pass
1717,1,True,2,1,3,1,1,pass
1718,1,True,3,1,4,1,1,pass
1719,1,True,2,2,4,1,1,pass
1720,2,True,47,33,80,2,1,pass
1721,2,True,29,5,34,2,2,pass
1722,2,True,5,14,19,2,1,pass
1723,1,True,1,1,2,1,1,pass
1724,1,True,0,2,2,1,1,fail
1725,1,True,5,1,6,1,1,fail
1726,1,True,11,0,11,1,1,pass
1727,1,True,1,1,2,1,1,pass
1728,1,True,14,3,17,1,1,fail
1729,1,True,3,2,5,1,1,pass
1730,1,True,18,21,39,1,1,pass
1731,1,True,1,1,2,1,1,pass
1732,1,True,59,33,92,1,1,pass
1734,2,True,1,1,2,1,1,pass
1735,1,True,1,1,2,1,1,pass
1736,1,True,1,1,2,1,1,pass
1739,2,True,28,24,52,1,1,pass
1740,2,True,4,13,17,1,1,fail
1741,1,True,4,13,17,1,1,pass
1742,1,True,3,0,3,1,1,pass
1743,1,True,25,24,49,1,1,pass
1744,2,True,1,1,2,1,1,pass
1745,1,True,1,1,2,1,1,pass
1746,2,True,0,0,0,1,1,pass
1747,2,True,2949,1161,4110,26,8,pass
1748,2,True,66,8,74,4,2,pass
1749,2,True,49,0,49,2,1,pass
1750,2,True,13,6,19,1,1,pass
1751,1,True,19,5,24,2,1,pass
1752,1,True,13,6,19,1,1,pass
1753,1,True,5,1,6,1,1,pass
1754,1,True,1,1,2,1,1,pass
1755,2,True,4,2,6,1,1,pass
1756,1,True,4,2,6,1,1,pass
1757,1,True,27,0,27,1,1,pass
1758,1,True,1,1,2,1,1,pass
1759,1,True,25,11,36,1,1,fail
1760,1,True,4,17,21,1,1,fail
1761,1,True,1,9,10,1,1,fail
1762,1,True,5,2,7,1,1,fail
1763,1,True,39,4,43,2,1,fail
1764,2,True,78,34,112,4,2,fail
1765,2,True,64,31,95,2,1,pass
1766,2,True,3,3,6,1,1,pass
1767,1,True,1,1,2,1,1,pass
1768,1,True,1,0,1,1,1,fail
1769,1,True,15,1,16,2,1,fail
1770,2,True,20,9,29,3,2,fail
1771,2,True,2,2,4,1,1,pass
1772,1,True,2,2,4,1,1,pass
1773,1,True,3,1,4,2,1,pass
1774,1,True,85,41,126,4,1,pass
1775,1,True,39,0,39,2,1,pass
1776,1,True,23,6,29,1,1,pass
1777,1,True,27,0,27,1,1,pass
1778,1,True,2,1,3,2,1,pass
1779,1,True,3,3,6,2,1,pass
1780,1,True,46,22,68,2,1,pass
1781,1,True,6,11,17,2,2,pass
1782,1,True,1,1,2,1,1,fail
1783,2,True,0,0,0,0,0,fail
1785,2,True,17,3,20,1,1,pass
1786,1,True,71,16,87,3,3,fail
1787,1,True,0,1,1,1,1,pass
1788,1,True,18,3,21,1,1,pass
1789,1,True,1,0,1,1,1,pass
1790,1,True,1,0,1,1,1,pass
1791,2,True,1,1,2,1,1,fail
1792,2,True,1,4,5,1,1,pass
1793,1,True,2585,1078,3663,24,7,pass
1794,1,True,49,31,80,2,1,fail
1795,1,True,1,4,5,1,1,pass
1796,2,True,2,2,4,1,1,pass
1797,1,True,2,2,4,1,1,pass
1798,1,True,1,1,2,1,1,pass
1799,2,True,1,7,8,1,1,pass
1800,2,True,1,4,5,1,1,pass
1801,1,True,1,7,8,1,1,pass
1802,1,True,1,4,5,1,1,pass
1803,2,True,12,2,14,1,1,pass
1804,1,True,12,2,14,1,1,pass
1805,2,True,55,25,80,3,1,pass
1806,2,True,4,1,5,2,1,pass
1807,1,True,3,3,6,1,1,pass
1808,2,True,674,21,695,1,1,pass
1809,1,True,6,9,15,2,1,pass
1811,1,True,2,0,2,1,1,pass
1812,1,True,1,1,2,1,1,pass
1813,1,True,2,2,4,1,1,fail
1814,1,True,1,1,2,1,1,fail
1816,2,True,674,21,695,1,1,pass
1817,1,True,674,21,695,1,1,pass
1819,1,True,2,1,3,1,1,pass
1820,2,True,12,0,12,1,1,pass
1821,1,True,12,0,12,1,1,pass
1822,2,True,18,18,36,4,1,pass
1823,1,True,2,2,4,1,1,pass
1824,1,True,1,1,2,1,1,pass
1825,1,True,15,15,30,2,1,pass
1826,2,True,23,1,24,1,1,pass
1827,1,True,5,4,9,1,1,pass
1828,2,True,68,50,118,3,1,pass
1829,1,True,1,1,2,1,1,pass
1830,1,True,4,5,9,1,1,pass
1831,2,True,46,11,57,4,2,pass
1832,1,True,2,6,8,1,1,pass
1833,1,True,68,45,113,3,1,pass
1834,1,True,1,1,2,1,1,pass
1835,1,True,1,1,2,1,1,pass
1836,1,True,33,23,56,3,2,pass
1837,2,True,17,3,20,2,1,pass
1838,1,True,29,4,33,2,1,pass
1839,2,True,96,86,182,5,1,pass
1840,1,True,96,86,182,5,1,pass
1841,1,True,17,2,19,2,1,pass
1842,2,True,1,1,2,1,1,pass
1843,1,True,1,1,2,1,1,pass
1844,2,True,1,1,2,1,1,pass
1845,1,True,1,1,2,1,1,pass
1846,2,True,2,1,3,1,1,pass
1847,1,True,1,2,3,1,1,pass
1848,1,True,2,2,4,1,1,fail
1849,1,True,2,0,2,1,1,pass
1850,2,True,1,1,2,1,1,fail
1851,2,True,4,6,10,1,1,pass
1852,1,True,6,6,12,1,1,pass
1853,1,True,1,1,2,1,1,pass
1854,1,True,2,2,4,1,1,pass
1855,1,True,0,1,1,1,1,pass
1857,2,True,16,11,27,3,1,pass
1858,1,True,5,7,12,2,1,pass
1860,2,True,2,2,4,1,1,pass
1861,2,True,9,9,18,2,1,pass
1862,2,True,401,122,523,7,2,pass
1863,1,True,1,1,2,1,1,pass
1864,1,True,401,122,523,7,2,pass
1865,1,True,1,1,2,1,1,pass
1866,2,True,1,1,2,1,1,pass
1867,1,True,1,1,2,1,1,pass
1868,1,True,2,2,4,1,1,pass
1869,2,True,10,12,22,1,1,pass
1870,2,True,0,0,0,0,0,pass
1873,2,True,3,2,5,1,1,pass
1874,1,True,3,2,5,1,1,pass
1875,2,True,1,1,2,1,1,pass
1876,2,True,17,12,29,5,1,fail
1877,2,True,13,8,21,4,1,pass
1878,2,True,4,4,8,1,1,pass
1879,1,True,1,1,2,1,1,pass
1880,1,True,4,0,4,1,1,pass
1881,1,True,9,8,17,3,1,pass
1882,1,True,4,4,8,1,1,pass
1883,1,True,4,4,8,1,1,pass
1884,2,True,117,111,228,6,2,pass
1885,1,True,45,6,51,2,2,pass
1891,2,True,725,0,725,1,1,pass
1892,2,True,19,27,46,2,1,pass
1893,2,True,3,3,6,1,1,pass
1894,1,True,3,3,6,1,1,pass
1895,1,True,1,2,3,1,1,fail
1896,1,True,725,0,725,1,1,pass
1897,1,True,1,0,1,1,1,pass
1898,1,True,1,1,2,1,1,fail
1899,1,True,17,26,43,2,1,fail
1900,1,True,7,7,14,1,1,pass
1901,2,True,3,3,6,1,1,pass
1902,2,True,1,1,2,1,1,pass
1903,2,True,4,3,7,1,1,fail
1904,1,True,4,3,7,1,1,pass
1905,1,True,1,1,2,1,1,pass
1906,1,True,3,3,6,1,1,pass
1907,2,True,14,1,15,1,1,pass
1908,2,True,1,1,2,1,1,pass
1909,2,True,3,3,6,1,1,pass
1910,1,True,3,3,6,1,1,pass
1911,1,True,2,2,4,1,1,pass
1912,1,True,7,7,14,1,1,fail
1913,1,True,1,1,2,1,1,pass
1914,1,True,14,1,15,1,1,fail
1915,2,True,11,0,11,1,1,pass
1916,1,True,11,0,11,1,1,pass
1917,2,True,15,4,19,2,1,pass
1918,2,True,3,3,6,1,1,pass
1919,1,True,3,3,6,1,1,pass
1920,1,True,4,2,6,1,1,pass
1921,1,True,10,1,11,2,1,pass
1922,1,True,1,1,2,1,1,pass
1923,2,True,5,6,11,1,1,pass
1924,2,True,2,3,5,1,1,pass
1925,2,True,6,6,12,4,1,fail
1926,1,True,6,6,12,4,1,pass
1927,1,True,3,4,7,1,1,pass
1928,1,True,3,3,6,1,1,pass
1929,1,True,2,3,5,1,1,pass
1930,2,True,6,0,6,1,1,pass
1931,1,True,1,1,2,1,1,pass
1932,1,True,6,0,6,1,1,fail
1933,2,True,7,3,10,2,1,pass
1934,1,True,2,2,4,1,1,pass
1935,1,True,1,1,2,1,1,pass
1936,2,True,1,1,2,1,1,pass
1937,2,True,17,9,26,1,1,pass
1938,1,True,1,1,2,1,1,pass
1939,1,True,2,2,4,1,1,pass
1940,2,True,2298,375,2673,5,2,pass
1941,2,True,101,15,116,3,1,pass
1942,2,True,88,2,90,1,1,pass
1943,1,True,43,1,44,1,1,pass
1944,1,True,1,1,2,1,1,pass
1945,1,True,1,1,2,1,1,pass
1946,1,True,6,6,12,1,1,fail
1947,1,True,3,3,6,1,1,pass
1948,1,True,8,6,14,1,1,fail
1949,1,True,6,6,12,1,1,pass
1950,1,True,9,7,16,1,1,pass
1951,2,True,16,15,31,2,1,fail
1955,2,True,13,13,26,1,1,pass
1956,1,True,6,6,12,2,1,pass
1957,1,True,11,8,19,1,1,fail
1962,1,True,2,2,4,1,1,pass
1967,1,True,22,1,23,1,1,pass
1968,1,True,13,13,26,1,1,pass
1969,2,True,3,2,5,1,1,pass
1971,1,True,51,2,53,1,1,pass
1972,1,True,1,1,2,1,1,pass
1973,1,True,2,2,4,1,1,pass
1974,1,True,17,9,26,1,1,fail
1975,1,True,3,2,5,1,1,pass
1976,2,True,37,7,44,2,1,pass
1977,1,True,1,1,2,1,1,pass
1978,1,True,4,4,8,2,1,pass
1979,2,True,4,1,5,1,1,pass
1980,1,True,3,3,6,1,1,pass
1981,2,True,4,3,7,1,1,pass
1982,2,True,0,1,1,1,1,pass
1983,2,True,76,27,103,4,1,pass
1984,1,True,0,1,1,1,1,pass
1985,2,True,107,22,129,4,1,pass
1986,1,True,4,3,7,1,1,pass
1987,1,True,5,20,25,2,1,pass
1988,2,True,127,41,168,7,1,pass
1989,2,True,96,15,111,4,1,fail
1990,1,True,50,16,66,2,1,fail
1991,2,True,107,22,129,4,1,pass
1992,1,True,1,1,2,1,1,pass
1993,2,True,2,1,3,1,1,pass
1994,1,True,8,4,12,3,1,pass
1995,2,True,14,14,28,1,1,pass
1996,2,True,2,1,3,1,1,pass
1998,2,True,1,1,2,1,1,pass
1999,1,True,1,1,2,1,1,pass
2000,1,True,2,2,4,1,1,pass
2001,1,True,7,7,14,1,1,pass
2003,2,True,3,3,6,2,1,pass
2004,1,True,2,2,4,1,1,pass
2005,1,True,1,1,2,1,1,pass
2006,2,True,2,2,4,2,1,pass
2007,1,True,4,1,5,1,1,pass
2008,1,True,1,1,2,1,1,pass
2009,1,True,2,2,4,2,1,pass
2010,1,True,44,21,65,2,1,pass
2011,1,True,48,7,55,3,1,pass
2012,1,True,1,1,2,1,1,pass
2013,1,True,8,7,15,1,1,pass
2014,2,True,297,211,508,5,1,pass
2015,1,True,2,2,4,1,1,pass
2016,1,True,224,192,416,5,1,pass
2017,1,True,1,0,1,1,1,pass
2018,1,True,105,22,127,4,1,fail
2019,1,True,72,18,90,4,1,pass
2020,2,True,858,622,1480,5,1,fail
2021,1,True,3,2,5,1,1,pass
2022,1,True,259,244,503,4,1,pass
2023,1,True,625,405,1030,4,1,pass
2024,2,True,188,70,258,2,2,pass
2025,2,True,3,3,6,1,1,fail
2026,1,True,1,1,2,1,1,pass
2028,1,True,55,34,89,2,2,pass
2029,2,True,24,20,44,1,1,pass
2030,1,True,24,20,44,1,1,pass
2031,1,True,3,0,3,1,1,pass
2032,1,True,131,37,168,1,1,pass
2033,2,True,102,78,180,3,1,pass
2034,1,True,2,2,4,1,1,pass
2035,1,True,102,78,180,3,1,fail
2036,2,True,2,1,3,1,1,pass
2037,2,True,27,27,54,3,1,pass
2038,1,True,2,1,3,1,1,pass
2039,2,True,330,107,437,4,2,pass
2040,1,True,27,27,54,3,1,pass
2041,2,True,24,6,30,2,1,pass
2042,1,True,11,2,13,1,1,pass
2043,2,True,26,26,52,3,1,pass
2044,2,True,27,27,54,3,1,pass
2045,1,True,1,1,2,1,1,pass
2046,1,True,12,3,15,1,1,fail
2047,1,True,27,27,54,3,1,pass
2049,1,True,42,40,82,3,1,pass
2050,1,True,6,5,11,1,1,pass
2051,1,True,1,1,2,1,1,pass
2052,1,True,327,107,434,3,2,pass
2053,2,True,0,3,3,1,1,pass
2054,2,True,7,5,12,2,1,pass
2055,1,True,0,3,3,1,1,pass
2056,1,True,7,5,12,2,1,pass
2057,2,True,4,0,4,1,1,pass
2058,2,True,2,0,2,1,1,pass
2059,1,True,2,0,2,1,1,pass
2060,1,True,4,0,4,1,1,pass
2061,2,True,3,3,6,1,1,pass
2062,1,True,4,4,8,1,1,pass
2063,1,True,5,5,10,1,1,pass
2064,2,True,73,88,161,1,1,pass
2065,1,True,73,88,161,1,1,pass
2066,2,True,249,118,367,9,2,pass
2067,1,True,29,33,62,6,2,pass
2068,1,True,2,2,4,1,1,pass
2069,1,True,3,3,6,1,1,pass
2070,1,True,13,13,26,1,1,pass
2071,1,True,20,16,36,1,1,pass
2072,1,True,27,13,40,2,2,pass
2073,1,True,17,17,34,1,1,pass
2074,2,True,3,3,6,1,1,pass
2075,1,True,3,3,6,1,1,pass
2076,1,True,26,13,39,1,1,pass
2077,2,True,2,0,2,1,1,pass
2078,1,True,193,89,282,4,2,pass
2079,1,True,2,0,2,1,1,pass
2080,2,True,31,0,31,1,1,pass
2081,2,True,3,4,7,2,2,pass
2082,1,True,3,1,4,1,1,pass
2083,1,True,1,2,3,2,2,pass
2088,2,True,24,0,24,1,1,pass
2090,1,True,8,2,10,1,1,pass
2092,2,True,82,8,90,2,1,pass
2093,2,True,131,107,238,1,1,pass
2094,1,True,131,107,238,1,1,pass
2095,2,True,440,7,447,4,2,pass
2096,2,True,399,116,515,15,4,pass
2097,2,True,1,1,2,1,1,pass
2098,1,True,1,1,2,1,1,pass
2099,2,True,4,7,11,1,1,pass
2100,1,True,4,7,11,1,1,pass
2101,1,True,16,13,29,1,1,pass
2103,2,True,1,1,2,1,1,pass
2104,1,True,1,1,2,1,1,pass
2105,2,True,26,11,37,2,1,pass
2106,2,True,190,62,252,10,3,pass
2110,2,True,5,0,5,1,1,pass
2111,1,True,5,0,5,1,1,pass
2112,2,True,2,1,3,1,1,pass
2113,1,True,2,1,3,1,1,pass
2114,2,True,13,2,15,1,1,pass
2115,1,True,13,2,15,1,1,pass
2116,2,True,2,1,3,1,1,pass
2117,1,True,2,1,3,1,1,pass
2118,2,True,74,40,114,2,1,pass
2120,1,True,1,1,2,1,1,pass
2122,2,True,50,3,53,4,2,pass
2123,2,True,4,3,7,2,1,pass
2124,2,True,41,12,53,2,1,pass
2125,1,True,41,12,53,2,1,pass
2126,1,True,4,3,7,2,1,pass
2130,2,True,243,77,320,13,4,pass
2131,2,True,13,0,13,1,1,pass
2132,2,True,6,3,9,1,1,pass
2133,1,True,6,3,9,1,1,pass
2134,1,True,6,5,11,1,1,pass
2135,1,True,3,3,6,1,1,pass
2136,2,True,5,2,7,1,1,pass
2137,2,True,78,40,118,2,1,fail
2138,1,True,4,6,10,1,1,pass
2139,1,True,5,2,7,1,1,pass
2140,1,True,78,40,118,2,1,pass
2142,1,True,1,1,2,1,1,pass
2143,1,True,23,7,30,2,1,pass
2144,1,True,52,0,52,1,1,pass
2145,2,True,15,3,18,2,1,pass
2146,1,True,71,20,91,3,1,pass
2147,1,True,8,5,13,1,1,pass
2148,1,True,4,3,7,1,1,pass
2151,1,True,3,2,5,1,1,pass
2153,1,True,59,48,107,1,1,pass
2154,1,True,73,6,79,2,1,pass
2155,1,True,0,2,2,1,1,pass
2158,2,True,7,3,10,1,1,pass
2159,2,True,39,4,43,2,1,pass
2160,2,True,20,1,21,3,3,pass
2161,2,True,64,25,89,6,2,pass
2162,1,True,13,0,13,1,1,pass
2163,1,True,11,11,22,1,1,pass
2164,1,True,28,0,28,1,1,pass
2165,1,True,1,3,4,1,1,pass
2166,1,True,2,65,67,1,1,pass
2168,1,True,0,4,4,1,1,pass
2170,1,True,11,4,15,1,1,pass
2171,1,True,1,1,2,1,1,pass
2172,1,True,1,1,2,1,1,pass
2173,1,True,15,2,17,1,1,pass
2174,1,True,8,2,10,1,1,pass
2175,1,True,7,1,8,3,3,pass
2177,2,True,1,1,2,1,1,pass
2178,1,True,1,1,2,1,1,pass
2179,2,True,2,2,4,2,1,pass
2181,1,True,2,2,4,2,1,pass
2182,1,True,64,25,89,6,2,pass
2183,2,False,85,0,85,3,2,pass
2184,2,False,5,2,7,1,1,pass
2185,2,True,10,0,10,3,2,pass
2186,2,True,60,16,76,6,2,pass
2187,1,True,10,0,10,3,2,pass
2188,2,True,47,16,63,4,2,pass
2189,1,True,47,16,63,4,2,pass
2190,2,True,1,1,2,1,1,pass
2191,1,True,1,1,2,1,1,pass
2192,1,False,2,0,2,1,1,pass
2193,1,False,1,1,2,1,1,pass
2194,1,False,0,2,2,1,1,pass
2195,1,False,13,0,13,1,1,pass
2196,1,False,1,1,2,1,1,pass
2197,1,False,3,2,5,1,1,pass
2198,1,False,3,2,5,1,1,pass
2199,1,False,1,1,2,1,1,pass
2200,1,False,1,1,2,1,1,pass
2201,1,False,4,4,8,1,1,pass
2202,1,False,5,0,5,1,1,fail
2204,2,True,2,2,4,1,1,pass
2205,1,True,2,2,4,1,1,pass
2206,2,True,22,3,25,1,1,pass
2207,1,True,22,3,25,1,1,pass
2208,2,True,21,3,24,1,1,pass
2209,2,True,24,4,28,1,1,pass
2210,1,True,4,4,8,1,1,pass
2212,2,True,1,1,2,1,1,pass
2213,1,True,21,3,24,1,1,pass
2214,1,True,1,1,2,1,1,pass
2215,1,True,60,16,76,6,2,pass
2216,2,True,2,1,3,1,1,pass
2217,2,True,44,7,51,3,1,pass
2218,1,True,4,4,8,1,1,pass
2219,2,True,10,5,15,1,1,pass
2220,1,True,10,5,15,1,1,pass
2221,1,True,5,5,10,1,1,pass
2222,2,True,1,1,2,1,1,pass
2223,1,True,1,1,2,1,1,pass
2224,1,True,5,5,10,1,1,pass
2225,1,True,6,1,7,1,1,pass
2226,1,True,32,0,32,1,1,pass
2227,2,False,152,0,152,2,2,pass
2228,2,True,87,35,122,3,1,pass
2229,1,False,14,0,14,1,1,pass
2230,1,False,138,0,138,1,1,pass
2231,2,True,26,9,35,1,1,pass
2232,2,True,53,10,63,6,1,pass
2233,1,True,26,9,35,1,1,pass
2234,1,True,4,0,4,1,1,pass
2235,1,True,8,7,15,1,1,pass
2236,1,True,2,1,3,1,1,pass
2237,1,True,3,0,3,1,1,pass
2238,2,True,2,1,3,1,1,pass
2240,1,True,2,0,2,1,1,pass
2241,1,True,1,1,2,1,1,pass
2246,1,True,2,1,3,1,1,pass
2247,2,True,10,5,15,2,1,pass
2248,2,True,1,4,5,1,1,pass
2249,2,True,607,195,802,15,3,pass
2250,1,True,1,1,2,1,1,pass
2251,1,True,86,34,120,3,1,fail
2253,1,True,10,5,15,2,1,pass
2259,1,True,920,203,1123,19,8,pass
2260,2,True,1,1,2,1,1,pass
2261,1,True,1,1,2,1,1,pass
2262,2,True,1,1,2,1,1,pass
2263,2,True,5,2,7,1,1,pass
2264,1,True,5,2,7,1,1,pass
2265,1,True,1,1,2,1,1,pass
2266,2,True,2,2,4,1,1,pass
2267,2,True,2,1,3,1,1,pass
2268,2,True,2,1,3,1,1,pass
2269,2,True,80,17,97,4,1,pass
2270,2,True,228,78,306,11,3,fail
2271,2,True,1,1,2,1,1,pass
2272,1,True,2,2,4,1,1,pass
2273,1,True,2,1,3,1,1,pass
2276,1,True,1,1,2,1,1,pass
2277,1,True,2,1,3,1,1,pass
2278,2,True,159,58,217,10,3,pass
2281,2,True,2,2,4,2,2,pass
2286,2,True,1,1,2,1,1,pass
2287,1,True,1,1,2,1,1,pass
2288,1,True,1,1,2,1,1,pass
2289,1,True,8,0,8,1,1,pass
2290,2,True,56,17,73,1,1,pass
2292,2,True,34,16,50,1,1,pass
2293,2,True,31,2,33,2,2,pass
2294,2,True,1,1,2,1,1,pass
2295,1,True,1,1,2,1,1,pass
2296,1,True,34,16,50,1,1,pass
2297,1,True,1,1,2,1,1,pass
2298,1,True,1,2,3,1,1,fail
2301,1,True,1,1,2,1,1,pass
2302,1,True,8,0,8,1,1,pass
2305,2,True,6,1,7,2,2,pass
2306,2,True,6,1,7,2,2,pass
2307,1,True,5,0,5,1,1,pass
2309,1,True,0,0,0,1,1,pass
2310,1,True,8,0,8,1,1,pass
2311,2,True,134,7,141,4,1,pass
2317,1,False,1,1,2,1,1,pass
2318,2,True,83,0,83,2,2,pass
2319,2,True,15,10,25,2,1,pass
2320,2,True,53,0,53,1,1,pass
2322,2,True,1,1,2,1,1,pass
2323,2,True,1,1,2,1,1,pass
2324,1,True,1,1,2,1,1,pass
2325,2,True,7,1,8,2,2,pass
2326,1,True,1,1,2,1,1,fail
2327,1,True,1,2,3,1,1,fail
2328,1,True,1,1,2,1,1,fail
2329,1,True,5,7,12,1,1,fail
2330,2,True,2,2,4,1,1,pass
2331,1,True,2,2,4,1,1,pass
2335,2,True,6,0,6,1,1,pass
2336,2,True,1,1,2,1,1,pass
2337,2,True,1,1,2,1,1,pass
2338,2,True,1,1,2,1,1,pass
2339,1,True,1,1,2,1,1,pass
2340,1,True,1,1,2,1,1,pass
2341,1,True,6,0,6,1,1,pass
2342,2,True,0,0,0,0,0,pass
2346,1,True,8,0,8,1,1,pass
2347,2,True,2,2,4,2,1,pass
2348,2,True,2,2,4,2,1,pass
2349,1,True,10,5,15,2,1,pass
2350,1,True,3,2,5,2,1,fail
2351,1,True,1,1,2,1,1,fail
2352,1,True,1,0,1,1,1,fail
2353,1,True,1,1,2,1,1,fail
2354,1,True,99,56,155,9,2,fail
2355,2,True,17,14,31,1,1,pass
2356,1,True,2,2,4,1,1,pass
2357,1,True,4,5,9,1,1,pass
2359,1,True,1,1,2,1,1,pass
2360,1,True,75,0,75,1,1,pass
2366,2,False,112,71,183,3,2,pass
2367,2,True,139,44,183,4,2,pass
2368,2,False,21,1,22,2,2,pass
2369,1,True,12,20,32,2,1,pass
2370,1,True,93,70,163,2,2,pass
2372,1,True,2,6,8,2,1,pass
2373,1,True,15,6,21,2,1,pass
2374,2,True,108,25,133,3,2,pass
2375,2,True,1,2,3,1,1,pass
2376,1,True,1,2,3,1,1,pass
2377,1,True,1,1,2,1,1,pass
2378,1,True,27,20,47,3,2,pass
2379,1,True,7,8,15,1,1,pass
2380,1,True,1,1,2,1,1,pass
2381,1,True,2,2,4,2,1,pass
2382,1,True,2,2,4,1,1,pass
2387,1,False,2,1,3,1,1,pass
2388,1,True,5,5,10,3,3,pass
2389,1,False,1,1,2,1,1,pass
2390,1,True,6,4,10,1,1,pass
2391,1,True,59,33,92,3,2,pass
2392,1,True,49,0,49,1,1,pass
2396,1,True,0,0,0,1,1,pass
2397,1,False,1,1,2,1,1,pass
2398,2,True,4,1,5,1,1,pass
2399,1,True,4,1,5,1,1,pass
2400,2,True,21,1,22,2,2,pass
2401,1,True,3,3,6,1,1,pass
2402,1,True,11,0,11,1,1,pass
2403,1,True,1,1,2,1,1,pass
2404,1,True,4,2,6,1,1,pass
2405,1,True,2,2,4,1,1,pass
2407,1,True,1,1,2,1,1,pass
2410,2,True,686,530,1216,10,4,fail
2411,1,True,10,1,11,1,1,fail
2412,2,True,1,1,2,1,1,pass
2413,2,True,1,0,1,1,1,pass
2414,1,True,1,1,2,1,1,pass
2415,1,False,2,2,4,1,1,pass
2416,1,True,1,0,1,1,1,pass
2417,2,True,1,1,2,1,1,pass
2418,1,True,1,1,2,1,1,pass
2419,2,True,1,0,1,1,1,pass
2420,1,True,1,1,2,1,1,pass
2421,1,True,1,0,1,1,1,pass
2422,1,True,1,0,1,1,1,pass
2423,1,True,25,31,56,1,1,pass
2424,1,True,4,2,6,1,1,pass
2425,1,True,43,0,43,2,1,pass
2426,1,True,50,43,93,4,2,pass
2427,1,False,2,0,2,1,1,pass
2428,1,True,28,30,58,1,1,pass
2429,2,True,131,3,134,3,2,pass
2430,1,True,1,1,2,1,1,pass
2431,2,True,0,0,0,0,0,pass
2434,2,True,1,0,1,1,1,pass
2435,1,True,1,0,1,1,1,pass
2436,2,True,36,91,127,3,3,pass
2437,2,True,393,420,813,7,1,pass
2438,2,True,67,2,69,2,2,pass
2439,1,True,67,2,69,2,2,pass
2442,1,True,13,6,19,1,1,pass
2443,1,True,211,148,359,7,1,pass
2448,2,True,2,4,6,1,1,pass
2449,1,True,1,2,3,1,1,pass
2450,1,True,1,2,3,1,1,pass
2451,2,True,16,8,24,3,2,pass
2452,1,True,5,0,5,1,1,pass
2453,2,True,1,1,2,1,1,pass
2454,1,True,1,1,2,1,1,pass
2455,1,True,34,106,140,4,3,pass
2456,1,True,112,1,113,5,3,fail
2457,2,True,1642,636,2278,17,3,pass
2458,1,True,150,59,209,2,1,pass
2461,2,True,27,5,32,1,1,pass
2462,2,True,12,1,13,2,1,pass
2463,1,True,7,0,7,1,1,pass
2464,1,True,27,5,32,1,1,pass
2465,1,True,19,11,30,2,1,pass
2466,1,True,4,0,4,1,1,pass
2469,1,False,1,0,1,1,1,pass
2470,1,True,0,21,21,2,1,pass
2471,1,False,1,1,2,1,1,pass
2472,1,False,5,2,7,1,1,pass
2473,2,True,186,30,216,6,2,pass
2474,1,True,16,8,24,3,2,pass
2475,1,True,14,9,23,1,1,pass
2482,2,True,5,1,6,1,1,pass
2483,1,True,5,1,6,1,1,pass
2484,1,True,165,4,169,5,1,pass
2485,1,False,11,12,23,1,1,pass
2486,1,False,3,3,6,1,1,pass
2487,1,False,10,2,12,1,1,pass
2488,2,True,9,5,14,1,1,pass
2489,1,False,1,1,2,1,1,pass
2490,1,False,1,1,2,1,1,pass
2491,1,True,11,3,14,1,1,pass
2492,2,True,29,5,34,1,1,pass
2493,1,True,29,5,34,1,1,pass
2494,2,True,46,0,46,1,1,pass
2495,1,True,46,0,46,1,1,pass
2496,2,True,1,1,2,1,1,pass
2497,1,True,1,1,2,1,1,pass
2498,1,True,0,4,4,1,1,pass
2499,1,False,4,6,10,1,1,pass
2500,2,True,1,1,2,1,1,pass
2501,1,True,1,1,2,1,1,pass
2502,2,True,215,220,435,1,1,pass
2503,1,True,215,220,435,1,1,pass
2504,2,True,8,0,8,1,1,pass
2505,1,True,8,0,8,1,1,pass
2506,2,True,16,10,26,3,2,pass
2507,1,False,2,2,4,1,1,pass
2508,1,True,16,10,26,3,2,pass
2509,1,False,1,1,2,1,1,pass
2510,1,False,1,0,1,1,1,pass
2511,1,False,1,1,2,1,1,pass
2512,1,False,3,0,3,1,1,pass
2513,2,True,3,0,3,1,1,pass
2514,1,True,3,0,3,1,1,pass
2515,1,True,117,116,233,1,1,pass
2516,1,True,1,2,3,2,1,pass
2517,1,True,79,1,80,3,2,pass
2518,2,True,425,178,603,2,2,pass
2519,1,True,54,42,96,1,1,pass
2520,1,True,170,0,170,2,2,pass
2521,1,True,328,263,591,1,1,pass
2522,2,True,45,30,75,1,1,fail
2523,1,True,0,1,1,1,1,fail
2524,2,True,193,90,283,1,1,fail
2525,2,True,167,100,267,10,1,fail
2526,1,True,45,29,74,1,1,fail
2527,2,True,121,81,202,8,1,fail
2528,2,True,49,23,72,2,1,fail
2529,2,True,9,2,11,1,1,fail
2530,2,True,6,0,6,1,1,fail
2531,1,True,6,0,6,1,1,fail
2532,1,True,8,105,113,3,1,fail
2534,1,True,49,23,72,2,1,fail
2536,2,True,1,1,2,1,1,fail
2537,1,True,1,1,2,1,1,fail
2538,1,True,218,103,321,1,1,fail
2539,2,True,1,1,2,1,1,fail
2540,1,True,1,1,2,1,1,fail
2541,2,True,214,111,325,12,5,fail
2542,2,True,28,9,37,3,2,fail
2543,1,False,6,1,7,1,1,fail
2544,1,False,1,1,2,1,1,fail
2545,1,False,1,1,2,1,1,fail
2546,1,False,1,1,2,1,1,fail
2547,1,True,12,1,13,1,1,fail
2548,2,True,8,4,12,2,1,fail
2550,2,True,5,2,7,1,1,fail
2551,2,True,1,1,2,1,1,fail
2552,1,True,5,2,7,1,1,fail
2553,2,True,18,0,18,1,1,pass
2554,2,True,1,1,2,1,1,pass
2555,2,True,3,3,6,1,1,pass
2563,2,True,0,1,1,1,1,pass
2565,1,False,2,2,4,1,1,pass
2566,1,False,2,2,4,1,1,pass
2567,2,True,35,31,66,2,1,pass
2569,2,True,19,2,21,2,2,pass
2572,2,True,0,1,1,1,1,pass
2574,2,True,1,0,1,1,1,pass
2575,2,True,2,1,3,1,1,pass
2578,1,False,2,2,4,1,1,pass
2579,2,True,90,54,144,3,2,pass
2582,2,True,3,4,7,1,1,pass
2583,1,False,1,1,2,1,1,pass
2584,2,True,6,1,7,1,1,pass
2586,2,True,1,1,2,1,1,pass
2588,2,True,1,1,2,1,1,pass
2590,2,True,1,1,2,1,1,pass
2594,2,True,9,10,19,1,1,pass
2596,1,False,14,9,23,1,1,pass
2597,2,True,12,10,22,1,1,pass
2599,2,True,4,8,12,1,1,pass
2601,2,True,11,10,21,1,1,pass
2602,2,True,36,1,37,1,1,pass
2606,2,True,1,1,2,1,1,pass
2608,2,True,47,49,96,6,2,pass
2610,2,True,1,1,2,1,1,pass
2611,2,True,6,8,14,1,1,pass
2620,2,True,19,3,22,1,1,pass
2622,2,True,35,11,46,4,2,pass
2626,2,True,1,1,2,1,1,pass
2627,2,True,4,4,8,1,1,pass
2630,2,True,25,17,42,4,2,pass
2634,2,True,18,6,24,4,2,pass
2635,2,True,2,2,4,1,1,pass
2641,1,False,4,2,6,1,1,pass
2642,1,False,2,0,2,1,1,pass
2643,2,True,15,0,15,1,1,pass
2647,1,False,1,2,3,1,1,pass
2648,1,False,2,2,4,1,1,pass
2649,1,False,3,2,5,1,1,pass
2650,1,False,1,1,2,1,1,pass
2651,2,True,375,16,391,4,2,pass
2652,2,True,176,12,188,5,2,pass
2658,1,False,1,1,2,1,1,pass
2659,1,False,1,1,2,1,1,pass
2662,1,False,2,2,4,1,1,pass
2663,1,False,2,0,2,1,1,pass
2664,1,False,2,0,2,1,1,pass
2665,1,False,1,1,2,1,1,pass
2666,1,False,1,0,1,1,1,pass
2671,1,False,1,1,2,1,1,pass
2672,2,True,2,2,4,1,1,pass
2674,2,True,307,16,323,5,2,pass
2676,2,True,3,3,6,1,1,pass
2679,1,False,8,7,15,1,1,pass
2689,2,True,207,2,209,5,2,pass
2691,2,True,22,16,38,1,1,pass
2692,2,True,1,3,4,1,1,pass
2706,1,False,0,11,11,1,1,pass
2707,2,True,1,1,2,1,1,pass
2708,2,True,127,38,165,5,2,pass
2711,2,True,2,2,4,2,1,pass
2720,2,True,5,2,7,3,3,pass
2722,1,False,1,1,2,1,1,pass
2723,1,False,1,1,2,1,1,pass
2724,1,False,40,0,40,1,1,pass
2725,2,True,17,17,34,1,1,pass
2727,2,True,14,1,15,1,1,pass
2729,2,True,2,1,3,1,1,pass
2731,2,True,5,4,9,1,1,pass
2733,1,False,0,1,1,1,1,pass
2734,2,True,227,14,241,11,7,pass
2735,2,True,1,1,2,1,1,pass
2736,2,True,1,1,2,1,1,pass
2737,1,False,5,0,5,1,1,pass
2741,2,True,16,11,27,1,1,pass
2745,2,True,38,7,45,1,1,pass
2752,2,True,3,1,4,1,1,pass
2754,2,True,985,972,1957,14,1,pass
2760,1,False,0,2,2,1,1,pass
2761,1,False,3,3,6,1,1,pass
2762,1,False,1,0,1,1,1,pass
2763,1,False,0,1,1,1,1,pass
2764,1,False,0,46,46,1,1,pass
2765,2,True,167,36,203,6,2,pass
2772,1,False,8,0,8,1,1,pass
2773,2,True,77,2,79,5,3,pass
2778,2,True,7,1,8,1,1,pass
2782,1,False,1,6,7,1,1,pass
2800,1,False,4,0,4,1,1,pass
2801,1,False,4,0,4,1,1,pass
2802,1,False,350,9,359,1,1,pass
2803,1,False,3,0,3,1,1,pass
2804,2,True,4,0,4,1,1,pass
2807,2,True,132,126,258,1,1,pass
2810,1,False,1,0,1,1,1,pass
2811,2,True,20,6,26,2,1,pass
2813,2,True,20,8,28,1,1,pass
2819,1,False,2,1,3,1,1,pass
2820,1,False,2,1,3,1,1,pass
2821,2,True,2,2,4,1,1,pass
2823,2,True,15,8,23,4,2,pass
2827,2,True,234,3,237,5,3,pass
2828,2,True,44,11,55,2,2,pass
2829,2,True,46,25,71,4,1,pass
2830,2,True,28,8,36,7,3,pass
2851,1,False,7,0,7,1,1,pass
2852,2,True,8,0,8,1,1,pass
2855,2,True,5,0,5,1,1,pass
2856,1,False,7,0,7,1,1,pass
2857,1,False,7,0,7,1,1,pass
2859,1,False,1,1,2,1,1,pass
2860,1,False,1,1,2,1,1,pass
2861,1,False,6,6,12,1,1,pass
2862,1,False,1,1,2,1,1,pass
2863,2,True,7,6,13,2,1,pass
2866,1,False,1,2,3,1,1,pass
2867,1,False,1,2,3,1,1,pass
2868,2,True,10,4,14,1,1,pass
2869,2,True,11,4,15,1,1,pass
2870,2,True,16,2,18,1,1,pass
2873,2,True,1,1,2,1,1,pass
2879,2,True,15,1,16,1,1,pass
2880,2,True,16,2,18,1,1,pass
2883,2,True,5,4,9,1,1,pass
2886,1,False,0,1,1,1,1,pass
2887,2,True,6,4,10,2,2,pass
2888,2,True,1,1,2,1,1,pass
2889,2,True,1,1,2,1,1,pass
2890,2,True,1,1,2,1,1,pass
2896,1,False,2,2,4,1,1,pass
2897,1,False,2,2,4,1,1,pass
2898,1,False,1,1,2,1,1,pass
2899,1,False,1,1,2,1,1,pass
2900,1,False,0,18,18,1,1,pass
2901,1,False,0,20,20,1,1,pass
2902,1,False,0,20,20,1,1,pass
2903,1,False,1,1,2,1,1,pass
2904,2,True,34,0,34,1,1,pass
2906,1,False,1,1,2,1,1,pass
2907,1,False,43,0,43,1,1,pass
2908,2,True,4,3,7,1,1,pass
2911,1,False,6,4,10,1,1,pass
2912,1,False,2,2,4,1,1,pass
2913,1,False,5,4,9,1,1,pass
2914,2,True,25,4,29,3,2,pass
2921,2,True,6,0,6,1,1,pass
2925,1,False,1,1,2,1,1,pass
2926,2,True,1,1,2,1,1,pass
2927,1,False,0,2,2,1,1,pass
2928,1,False,0,2,2,1,1,pass
2929,1,False,2,0,2,1,1,pass
2932,1,False,0,2,2,1,1,pass
2933,1,False,2,0,2,1,1,pass
2934,1,False,2,0,2,1,1,pass
2935,2,True,4,4,8,1,1,pass
2937,1,False,2,0,2,1,1,pass
2938,1,False,0,1,1,1,1,pass
2939,1,False,0,2,2,1,1,pass
2940,1,False,1,1,2,1,1,pass
2941,2,True,42,19,61,1,1,pass
2942,2,True,18,19,37,1,1,pass
2946,2,True,137,39,176,5,2,pass
2948,1,False,0,0,0,1,1,pass
2949,2,True,62,2,64,14,5,pass
2956,1,False,3,0,3,1,1,pass
2957,1,False,3,0,3,1,1,pass
2958,1,False,1,1,2,1,1,pass
2959,1,False,1,1,2,1,1,pass
2960,2,True,39,37,76,4,1,pass
2965,1,False,5,3,8,1,1,pass
2966,2,True,5,3,8,1,1,pass
2967,1,False,6,0,6,1,1,pass
2968,1,False,26,23,49,1,1,pass
2970,1,False,1,1,2,1,1,pass
2971,1,False,7,3,10,1,1,pass
2972,2,True,59,10,69,4,2,pass
2974,1,False,3,2,5,1,1,pass
2975,2,True,14,14,28,1,1,pass
2976,2,True,36,29,65,1,1,pass
2982,2,True,1,1,2,1,1,pass
2985,1,False,2,2,4,1,1,pass
2987,2,True,11,12,23,1,1,pass
2988,2,True,1,1,2,1,1,pass
2989,2,True,1,1,2,1,1,pass
2990,2,True,2,2,4,1,1,pass
2998,1,False,5,3,8,1,1,pass
2999,1,False,0,13,13,1,1,pass
3000,2,True,19,12,31,3,2,pass
3001,2,True,1,1,2,1,1,pass
3004,2,True,38,8,46,6,1,pass
3005,1,False,1,0,1,1,1,pass
3006,1,False,15,1,16,1,1,pass
3007,1,False,14,12,26,1,1,pass
3008,1,False,1,1,2,1,1,pass
3009,2,True,72,15,87,5,2,pass
3011,2,True,3,1,4,1,1,pass
3029,1,False,18,2,20,1,1,pass
3030,1,False,3,3,6,1,1,pass
3031,1,False,11,5,16,1,1,pass
3032,2,True,32,12,44,3,3,pass
3033,2,True,15,37,52,3,1,pass
3038,2,True,40,0,40,2,1,pass
3043,2,True,1,0,1,1,1,pass
3051,2,True,69,0,69,1,1,pass
3054,1,False,2,2,4,1,1,pass
3055,2,True,1,1,2,1,1,pass
3056,1,False,2,2,4,1,1,pass
3057,1,False,2,1,3,1,1,pass
3058,1,False,3,0,3,1,1,pass
3061,2,True,45,0,45,2,1,pass
3067,1,False,0,1,1,1,1,pass
3068,1,False,0,0,0,0,0,pass
3069,1,False,6,1,7,1,1,pass
3226,1,True,343,1151,1494,76,3,pass
3227,1,True,5,5,10,1,1,pass
3228,1,True,1,1,2,1,1,pass
3229,1,True,2,2,4,1,1,pass
3230,1,True,7,11,18,3,1,pass
3233,1,True,1,1,2,1,1,pass
3234,1,True,1,66,67,7,1,pass
3235,1,True,2,1,3,1,1,pass
3239,1,True,1,6,7,1,1,pass
3240,1,True,1,1,2,1,1,pass
3241,1,True,1,0,1,1,1,fail
3242,1,True,70,1,71,2,1,pass
3243,1,True,22,1,23,1,1,pass
3253,1,True,50,0,50,2,1,pass
3254,1,True,39,17,56,2,1,pass
3255,1,True,0,4,4,1,1,pass
3256,1,True,16,3,19,3,2,pass
3257,1,True,90,25,115,8,2,pass
3258,1,True,8,23,31,6,3,pass
3259,1,True,2,2,4,2,2,pass
3271,1,True,24,1,25,2,1,pass
3272,1,True,12,16,28,1,1,pass
3273,1,True,1,1,2,1,1,pass
3274,1,True,11,0,11,1,1,fail
3276,1,True,1,1,2,1,1,pass
3277,1,True,1,1,2,1,1,pass
3278,1,True,1,1,2,1,1,pass
3279,1,True,5,5,10,3,2,pass
3280,1,True,1,1,2,1,1,pass
3281,1,True,147,39,186,10,3,fail
3283,1,True,5,2,7,1,1,pass
3284,1,True,0,0,0,14,3,fail
3285,1,True,164,7,171,2,1,pass
3290,1,True,16,0,16,1,1,pass
3291,1,True,1,1,2,1,1,pass
3293,1,True,188,5,193,4,2,pass
3294,1,True,75,7,82,3,1,pass
3295,1,True,42,17,59,3,1,pass
3296,1,True,3,3,6,1,1,pass
3297,1,True,3,1,4,1,1,pass
3298,2,True,24,4,28,4,3,pass
3299,1,True,23,3,26,3,3,pass
3301,1,True,30,16,46,2,1,pass
3302,1,True,6,6,12,2,2,fail
3305,1,True,5,1,6,1,1,pass
3306,1,True,4,0,4,1,1,pass
3307,1,True,5,15,20,2,2,pass
3310,1,True,49,13,62,3,1,fail
3311,1,True,3,4,7,1,1,pass
3312,1,True,28,12,40,1,1,fail
3313,1,True,12,0,12,1,1,pass
3316,1,True,92,25,117,3,1,pass
3317,1,True,79,281,360,20,2,pass
3318,2,True,84,134,218,8,1,pass
3319,1,True,53,133,186,7,1,pass
3322,1,True,10,1,11,2,1,pass
3323,1,True,7,5,12,1,1,pass
3324,1,True,1,1,2,1,1,pass
3325,1,True,56,2,58,6,2,pass
3326,1,True,1,1,2,1,1,pass
3327,2,True,20,3,23,3,3,pass
3328,1,True,20,3,23,3,3,fail
3329,1,True,571,774,1345,22,1,pass
3330,1,True,33,0,33,1,1,pass
3332,1,True,175,70,245,16,5,pass
3333,1,True,26,26,52,1,1,pass
3335,1,True,6,0,6,1,1,fail
3336,1,True,194,4,198,2,1,pass
3337,2,True,1,1,2,1,1,pass
3338,1,True,1,0,1,1,1,fail
3340,1,True,64,19,83,2,1,pass
3341,1,True,35,19,54,5,2,pass
3342,1,True,3,1,4,1,1,pass
3343,1,True,1,1,2,1,1,pass
3344,2,True,9,2,11,3,3,pass
3345,1,True,9,2,11,3,3,pass
3346,1,True,8,8,16,2,2,pass
3347,1,True,8,5,13,1,1,pass
3348,1,True,3,1,4,1,1,pass
3349,2,True,73,69,142,5,4,pass
3350,1,True,0,4,4,1,1,pass
3351,1,True,9,8,17,1,1,fail
3352,1,True,3,1,4,1,1,fail
3353,2,True,243,217,460,4,4,fail
3354,1,True,15,2,17,1,1,fail
3355,1,True,39,53,92,2,2,fail
3358,1,True,23,3,26,3,3,fail
3360,2,True,1835,1085,2920,59,4,pass
3361,1,True,1835,1085,2920,59,4,pass
3362,1,True,7,4,11,1,1,fail
3363,1,True,217,92,309,2,1,pass
3364,1,True,6,2,8,2,1,fail
3365,1,True,1,1,2,1,1,pass
3366,1,True,20,11,31,1,1,pass
3367,1,True,4,4,8,2,1,pass
3368,1,True,1,0,1,1,1,pass
3369,1,True,1,1,2,1,1,pass
3370,1,True,109,18,127,3,1,fail
3371,1,True,22,2,24,2,1,pass
3372,1,True,29,20,49,4,1,pass
3373,1,True,220,14,234,8,4,fail
3374,1,True,1,1,2,1,1,pass
3375,1,True,10,0,10,1,1,pass
3376,1,True,81,63,144,2,1,pass
3377,1,True,460,740,1200,26,6,pass
3378,1,True,4,0,4,1,1,pass
3379,1,True,8,0,8,1,1,pass
3381,1,True,49,0,49,1,1,pass
3382,1,True,42,3,45,2,1,pass
3383,1,True,7,2,9,2,1,pass
3384,1,True,62,45,107,1,1,pass
3385,1,True,0,4,4,1,1,pass
3386,1,True,1,1,2,1,1,pass
3388,1,True,1,0,1,1,1,fail
3390,2,True,11,7,18,2,2,pass
3391,1,True,1,1,2,1,1,pass
3392,1,True,11,7,18,2,2,pass
3393,1,True,1,1,2,1,1,pass
3395,2,True,233,57,290,10,4,pass
3396,1,True,16,4,20,2,1,pass
3397,1,True,3,3,6,3,2,pass
3400,1,True,7,5,12,2,1,pass
3401,1,True,5,5,10,5,1,pass
3402,1,True,10,8,18,3,1,fail
3403,1,True,0,3,3,1,1,fail
3404,1,True,4,0,4,1,1,pass
3405,2,True,16,4,20,3,3,pass
3406,1,True,16,4,20,3,3,fail
3407,1,True,68,4,72,6,3,pass
3408,1,True,29,1,30,2,1,fail
3409,2,True,96,77,173,4,4,fail
3410,1,True,22,3,25,3,3,fail
3412,2,True,61,62,123,11,4,pass
3413,1,True,5,3,8,4,2,pass
3414,1,True,42,4,46,5,4,pass
3416,1,True,56,59,115,7,3,fail
3417,1,True,40,37,77,29,2,fail
3418,1,True,1,1,2,1,1,fail
3419,1,True,20,0,20,2,1,fail
3420,1,True,19,4,23,5,1,pass
3421,1,True,39,1,40,2,1,pass
3422,2,True,8449,18424,26873,300,23,fail
3423,1,True,1,2,3,1,1,pass
3424,2,True,8451,18425,26876,300,23,fail
3425,2,True,164,65,229,14,3,fail
3426,1,True,10,2,12,2,1,fail
3428,2,True,233,167,400,8,8,pass
3429,1,True,19,3,22,3,3,pass
3432,1,True,119,3,122,30,2,pass
3433,1,True,48,4,52,2,1,pass
3434,1,True,1,1,2,1,1,pass
3435,1,True,1,1,2,1,1,pass
3436,1,True,25,2,27,1,1,fail
3437,2,True,140,64,204,13,3,fail
3438,1,True,28,71,99,4,3,pass
3439,1,True,3,3,6,1,1,pass
3440,1,True,2,0,2,1,1,pass
3441,1,True,4,0,4,1,1,pass
3442,2,True,77,56,133,7,7,fail
3443,1,True,17,3,20,3,3,fail
3447,1,True,4999,956,5955,45,7,pass
3448,1,True,73,28,101,6,1,pass
3449,1,True,41,1,42,2,1,pass
3450,1,True,189,21,210,8,5,pass
3451,1,True,33,5,38,1,1,pass
3453,1,True,2,2,4,1,1,pass
3454,1,True,1,1,2,1,1,fail
3455,2,True,147,169,316,6,6,pass
3456,1,True,26,3,29,3,3,fail
3458,1,True,114,160,274,2,2,fail
3459,2,True,25,0,25,2,1,pass
3460,1,True,13,6,19,2,1,pass
3461,2,True,53,11,64,3,2,pass
3462,1,True,8,1,9,1,1,pass
3463,2,True,65,1,66,2,1,pass
3464,1,True,65,1,66,2,1,pass
3465,2,True,13,6,19,2,1,pass
3466,1,True,2,2,4,2,1,pass
3467,1,True,1,1,2,1,1,pass
3468,1,True,4,0,4,1,1,pass
3469,1,True,196,7,203,16,3,pass
3470,2,True,110,50,160,3,1,pass
3471,1,True,12,5,17,1,1,pass
3472,2,True,1,1,2,1,1,pass
3473,1,True,53,11,64,3,2,pass
3474,2,True,1,1,2,1,1,pass
3475,1,True,1,1,2,1,1,pass
3476,2,True,1,1,2,1,1,pass
3477,1,True,1,1,2,1,1,pass
3478,1,True,6,1,7,2,1,pass
3479,1,True,52,4,56,2,2,pass
3480,2,True,5,50,55,3,3,pass
3481,1,True,1,2,3,1,1,pass
3482,1,True,4,48,52,2,2,fail
3483,2,True,1,1,2,1,1,fail
3484,1,True,1,1,2,1,1,pass
3485,1,True,48,4,52,2,2,fail
3486,2,True,1509,309,1818,97,14,pass
3487,1,True,32,32,64,2,2,pass
3488,2,True,47,13,60,5,2,fail
3489,2,True,12,3,15,3,3,pass
3490,1,True,12,3,15,3,3,pass
3491,1,True,64,3,67,4,1,pass
3492,2,True,20,1,21,2,1,pass
3493,2,True,12,12,24,1,1,pass
3494,1,True,20,1,21,2,1,pass
3495,1,True,12,12,24,1,1,pass
3496,2,True,6,0,6,1,1,pass
3497,1,True,6,0,6,1,1,pass
3498,2,True,9,0,9,1,1,fail
3499,2,True,12,3,15,3,3,pass
3500,1,True,12,3,15,3,3,pass
3501,1,True,5,4,9,3,1,pass
3502,2,True,1423,266,1689,95,14,pass
3503,2,True,11,3,14,3,3,pass
3504,1,True,11,3,14,3,3,pass
3505,1,True,2,1,3,1,1,pass
3506,2,True,25,3,28,3,3,pass
3507,1,True,25,3,28,3,3,pass
3508,1,True,273,170,443,2,2,pass
3509,1,True,10,0,10,2,1,pass
3510,1,True,214,24,238,5,3,pass
3511,1,True,353,41,394,16,3,pass
3512,1,True,12,12,24,1,1,pass
3513,1,True,3,3,6,1,1,pass
3514,1,True,28,0,28,1,1,pass
3515,2,True,3,4,7,1,1,pass
3516,1,True,3,4,7,1,1,pass
3517,2,True,10,0,10,2,1,pass
3518,2,True,8,9,17,1,1,pass
3519,1,True,8,9,17,1,1,pass
3520,2,True,1,1,2,1,1,pass
3521,2,True,16,1,17,1,1,pass
3522,2,True,16,27,43,1,1,pass
3523,1,True,1,0,1,1,1,pass
3524,1,True,1,1,2,1,1,pass
3525,1,True,101,32,133,8,4,pass
3526,1,True,1,1,2,1,1,pass
3527,1,True,10,0,10,2,1,pass
3528,1,True,1,1,2,1,1,pass
3529,1,True,48,4,52,2,2,fail
3531,1,True,2,3,5,1,1,pass
3532,1,True,27,7,34,4,1,pass
3533,1,True,0,9,9,1,1,pass
3534,2,True,1,1,2,1,1,pass
3535,1,True,1,1,2,1,1,pass
3536,1,True,16,27,43,1,1,pass
3537,1,True,129,2,131,6,2,pass
3538,1,True,286,232,518,21,3,pass
3539,1,True,341,64,405,10,3,pass
3542,1,True,89,3,92,3,1,pass
3543,1,True,3,5,8,1,1,pass
3550,1,True,0,2,2,1,1,pass
3552,1,True,148,5,153,21,4,pass
3553,1,True,104,11,115,3,1,pass
3554,1,True,2,2,4,2,1,pass
3555,1,True,101,55,156,4,3,pass
3556,1,True,26,8,34,2,1,fail
3559,1,True,72,36,108,1,1,fail
3560,1,True,110,50,160,3,1,pass
3561,1,True,38,1,39,2,1,pass
3562,1,True,24,0,24,3,2,pass
3563,1,True,69,16,85,4,3,fail
3564,1,True,2,2,4,1,1,pass
3565,1,True,2,2,4,2,1,pass
3566,1,True,34,4,38,4,2,pass
3567,1,True,1,5,6,1,1,pass
3568,1,True,9,7,16,4,1,pass
3569,1,True,44,101,145,1,1,pass
3570,1,True,44,101,145,1,1,pass
3571,1,True,84,52,136,3,1,fail
3572,1,True,234,119,353,1,1,pass
3576,1,True,5,0,5,1,1,fail
3577,1,True,12,1,13,1,1,pass
3578,1,True,1,1,2,1,1,pass
3579,1,True,1,1,2,1,1,pass
3580,1,True,10,2,12,2,1,pass
3581,1,True,125,9,134,26,5,pass
3582,1,True,1,1,2,1,1,fail
3583,1,True,19,4,23,3,2,pass
3584,1,True,20,1,21,2,1,pass
3585,1,True,6,1,7,1,1,pass
3586,1,True,11,3,14,3,2,pass
3587,1,True,2,2,4,1,1,pass
3588,1,True,1,1,2,1,1,pass
3589,1,True,4,0,4,1,1,pass
3590,2,True,8,6,14,3,3,pass
3591,1,True,4,0,4,1,1,pass
3593,1,True,15,3,18,3,3,fail
3594,1,True,58,25,83,6,2,pass
3595,1,True,142,89,231,1,1,pass
3596,1,True,5,1,6,1,1,pass
3597,1,True,120,36,156,14,3,pass
3598,1,True,1,1,2,1,1,pass
3599,1,True,273,15536,15809,279,17,pass
3600,1,True,2,2,4,2,1,pass
3601,1,True,7,0,7,1,1,pass
3602,2,True,15,0,15,2,2,pass
3603,1,True,15,0,15,2,2,pass
3604,1,True,822,211,1033,37,9,pass
3605,1,True,19,197,216,14,3,pass
3606,1,True,197,19,216,14,3,pass
3607,2,True,1,1,2,1,1,pass
3608,1,True,1,1,2,1,1,pass
3609,1,True,106,10,116,8,2,pass
3610,1,True,2,2,4,1,1,pass
3611,2,True,1,1,2,1,1,pass
3612,2,True,3,3,6,1,1,pass
3613,1,True,3,3,6,1,1,pass
3614,1,True,1,1,2,1,1,pass
3615,1,True,12,3,15,3,3,pass
3616,1,True,11,7,18,2,2,pass
3617,2,True,1,1,2,1,1,pass
3618,1,True,1,1,2,1,1,pass
3619,1,True,5,6,11,2,2,pass
3620,1,True,36,15,51,4,4,fail
3621,1,True,5,5,10,2,2,pass
3622,1,True,289,120,409,2,2,pass
3623,1,True,32,17,49,3,1,pass
3624,1,True,15,2,17,2,1,pass
3625,1,True,22,15,37,2,1,pass
3626,1,True,50,1,51,7,3,pass
3627,1,True,28,1,29,2,1,pass
3628,1,True,19,10,29,1,1,pass
3629,1,True,246,1,247,3,2,pass
3630,1,True,8,8,16,2,1,pass
3631,1,True,4,4,8,2,1,pass
3632,1,True,26,0,26,2,2,pass
3633,1,True,22,6,28,2,1,pass
3634,1,True,1,1,2,1,1,pass
3635,1,True,3,1,4,1,1,pass
3636,1,True,477,172,649,22,5,pass
3637,1,True,1,0,1,1,1,pass
3638,1,True,21,11,32,5,2,pass
3639,2,True,1,2,3,1,1,fail
3640,1,True,1,2,3,1,1,pass
3641,2,True,1,1,2,1,1,pass
3642,1,True,1,1,2,1,1,pass
3643,2,True,18,2,20,2,1,pass
3644,1,True,18,2,20,2,1,pass
3645,1,True,17,3,20,3,3,pass
3646,1,True,105,85,190,1,1,pass
3647,1,True,1,9,10,1,1,pass
3648,1,True,89,6,95,4,1,pass
3649,1,True,24,5,29,2,1,pass
3650,1,True,11,1,12,1,1,pass
3651,1,True,8,0,8,1,1,pass
3652,1,True,10,0,10,2,1,pass
3653,1,True,13,1,14,2,1,pass
3654,1,True,239,32,271,2,1,pass
3655,1,True,16,3,19,1,1,pass
3656,1,True,3,3,6,1,1,pass
3657,1,True,18,13,31,1,1,pass
3658,1,True,10,9,19,2,1,pass
3659,2,True,1,1,2,1,1,pass
3660,1,True,1,1,2,1,1,pass
3662,1,True,16,3,19,1,1,pass
3663,2,True,4425,1949,6374,160,14,pass
3664,2,True,12,48,60,7,3,pass
3665,1,True,11,3,14,3,3,pass
3666,1,True,1,45,46,4,1,pass
3667,2,True,4462,1950,6412,164,14,pass
3668,1,True,24,3,27,3,3,pass
3669,1,True,166,86,252,2,2,pass
3670,1,True,337,20,357,9,2,pass
3671,1,True,45,1,46,4,1,pass
3672,1,True,10,0,10,1,1,pass
3673,1,True,3,3,6,2,1,pass
3674,2,True,1,1,2,1,1,pass
3675,1,True,1,1,2,1,1,pass
3676,1,True,67,11,78,12,2,pass
3677,1,True,1,2,3,1,1,pass
3678,1,True,5,3,8,2,1,pass
3679,1,True,18,2,20,3,1,pass
3680,1,True,130,60,190,5,1,pass
3681,1,True,1,1,2,1,1,pass
3682,2,True,11,3,14,1,1,pass
3683,1,True,11,3,14,1,1,pass
3684,1,True,1,1,2,1,1,pass
3685,1,True,25,5,30,2,1,pass
3686,1,True,420,221,641,10,1,pass
3687,1,True,7,5,12,1,1,pass
3688,1,True,22,13,35,2,1,pass
3689,1,True,6,1,7,5,3,pass
3690,1,True,93,101,194,6,3,pass
3691,1,True,1,1,2,1,1,pass
3692,1,True,27,4,31,3,1,pass
3693,1,True,47,2,49,4,1,pass
3694,2,True,1,1,2,1,1,pass
3695,1,True,1,1,2,1,1,pass
3696,2,True,7,6,13,2,1,pass
3697,2,True,1,1,2,1,1,pass
3698,1,True,1,1,2,1,1,pass
3699,2,True,1,1,2,1,1,pass
3700,1,True,1,1,2,1,1,pass
3701,1,True,43,3,46,2,1,pass
3702,1,True,1,1,2,1,1,pass
3703,1,True,6,5,11,4,3,pass
3704,1,True,23,15,38,1,1,pass
3705,1,True,1,0,1,1,1,pass
3706,1,True,163,951,1114,12,4,pass
3707,1,True,13,5,18,2,1,pass
3708,1,True,225,229,454,55,7,pass
3709,1,True,37,1,38,2,1,pass
3710,1,True,22,10,32,7,2,pass
3711,1,True,6,2,8,3,3,pass
3712,1,True,60,47,107,2,2,pass
3713,1,True,49,1,50,2,1,pass
3714,1,True,8,0,8,1,1,pass
3715,1,True,32,0,32,2,1,pass
3716,1,True,53,0,53,2,1,pass
3717,1,True,20,9,29,2,1,pass
3718,2,True,4,2,6,1,1,pass
3719,2,True,5,0,5,1,1,pass
3720,2,True,2,3,5,1,1,pass
3721,1,True,2,3,5,1,1,pass
3722,1,True,2,2,4,2,2,pass
3723,1,True,38,3,41,2,1,pass
3724,1,True,5,3,8,3,3,pass
3725,1,True,3,1,4,1,1,pass
3726,1,True,1,3,4,1,1,pass
3727,1,True,39,5,44,4,1,pass
3728,1,True,3,1,4,1,1,pass
3729,1,True,17,19,36,4,2,pass
3730,1,True,8,5,13,2,1,fail
3731,1,True,84,5,89,2,1,pass
3732,2,True,6,0,6,2,1,pass
3733,1,True,6,6,12,1,1,pass
3734,1,True,12,6,18,1,1,fail
3735,1,True,6,0,6,1,1,fail
3736,1,True,4,1,5,1,1,fail
3737,1,True,41,26,67,1,1,fail
3738,1,True,1,1,2,1,1,fail
3739,1,True,0,6,6,1,1,fail
3740,1,True,21,13,34,3,1,fail
3741,1,True,6,3,9,3,3,fail
3743,1,True,47,3,50,2,1,pass
3744,1,True,36,16,52,4,1,pass
3745,1,True,241,1,242,3,3,pass
3746,1,True,3,3,6,3,2,pass
3747,1,True,1,1,2,1,1,pass
3748,1,True,2,2,4,2,1,pass
3749,1,True,36,1,37,2,1,pass
3750,1,True,434,65,499,32,7,pass
3751,2,True,1,1,2,1,1,pass
3752,1,True,76,0,76,1,1,pass
3753,1,True,8,8,16,1,1,pass
3754,1,True,2,2,4,1,1,pass
3755,1,True,6,2,8,3,3,pass
3756,1,True,33,6,39,1,1,pass
3758,1,True,16,16,32,2,1,pass
3759,1,True,11,3,14,4,3,pass
3760,1,True,34,0,34,2,1,pass
3761,1,True,0,0,0,0,0,pass
3762,1,True,2,0,2,1,1,pass
3763,1,True,5,0,5,1,1,pass
3764,1,True,18,0,18,1,1,pass
3765,1,True,26,1,27,2,1,pass
3766,1,True,36,4,40,2,1,pass
3767,1,True,9,10,19,4,1,pass
3768,1,True,3,3,6,1,1,pass
3769,1,True,5,5,10,4,2,pass
3770,1,True,136,3,139,2,1,pass
3771,1,True,6,2,8,3,3,pass
3772,1,True,54,52,106,1,1,pass
3773,1,True,6,1,7,2,1,pass
3774,1,True,56,24,80,3,1,pass
3775,1,True,0,1,1,1,1,pass
3776,1,True,1145,70,1215,18,7,pass
3777,2,True,1,0,1,1,1,pass
3778,1,True,6,0,6,2,1,pass
3779,1,False,1,0,1,1,1,pass
3780,1,True,2,2,4,1,1,pass
3781,1,True,0,1,1,1,1,fail
3782,1,True,2,1,3,1,1,fail
3783,1,True,9,5,14,5,1,fail
3784,2,True,6664,356,7020,137,8,fail
3785,1,True,3320,3185,6505,133,8,pass
3786,1,False,0,6,6,1,1,pass
3787,1,True,6212,33,6245,7,2,pass
3788,1,False,1,0,1,1,1,pass
3791,1,True,1,0,1,1,1,pass
3792,1,True,44,7,51,9,3,fail
3794,2,True,1940,599,2539,105,12,pass
3795,1,False,3,3,6,2,1,pass
3796,1,False,1,1,2,1,1,pass
3797,1,False,102,0,102,1,1,fail
3799,1,True,1,1,2,1,1,pass
3800,1,False,8,2,10,3,3,pass
3801,1,False,74,78,152,1,1,pass
3802,1,False,2,1,3,2,2,pass
3803,1,False,11,6,17,2,1,pass
3804,1,False,43,46,89,12,1,pass
3805,1,False,1,1,2,1,1,pass
3806,1,False,0,48,48,3,1,fail
3807,1,False,12,14,26,3,3,pass
3808,1,False,12,5,17,3,1,pass
3809,1,False,27,4,31,2,1,pass
3810,1,False,4,2,6,1,1,pass
3811,1,False,1,2,3,1,1,pass
3812,1,False,4,4,8,1,1,pass
3813,1,False,2,2,4,2,1,fail
3814,1,True,4,2,6,1,1,pass
3816,1,True,313,29,342,15,3,pass
3817,1,True,126,6,132,14,5,pass
3818,1,True,0,2,2,1,1,pass
3819,1,True,32,3,35,2,1,pass
3820,1,True,2,2,4,2,1,pass
3821,1,True,9,3,12,1,1,pass
3822,1,False,1,1,2,1,1,pass
3823,1,True,370,164,534,20,1,pass
3824,1,True,30,10,40,4,1,pass
3825,1,True,43,0,43,2,1,pass
3826,1,True,3,1,4,1,1,pass
3827,1,False,1,5,6,1,1,pass
3828,1,False,513,89,602,1,1,pass
3830,1,True,3,3,6,1,1,pass
3831,1,False,10,3,13,3,3,pass
3832,1,True,153,84,237,39,4,pass
3833,1,True,79,5,84,9,5,pass
3834,1,True,36,3,39,2,1,pass
3835,1,True,3,1,4,1,1,pass
3836,1,False,2,2,4,1,1,pass
3837,1,False,29,27,56,2,2,pass
3838,1,True,9,9,18,1,1,pass
3839,1,True,50,3,53,5,2,pass
3840,1,True,8,1,9,3,2,pass
3841,1,True,126,39,165,5,1,pass
3842,1,False,50,0,50,3,2,pass
3843,1,True,1,1,2,1,1,pass
3844,1,True,9,7,16,4,4,pass
3845,1,True,17,4,21,2,1,pass
3846,1,True,13,6,19,2,1,pass
3847,1,False,6,4,10,2,1,pass
3848,1,False,4,4,8,2,2,pass
3849,1,False,17,56,73,1,1,pass
3850,1,False,9,9,18,1,1,pass
3851,2,False,223,79,302,31,3,pass
3852,1,True,78,2,80,4,3,pass
3853,1,True,1,1,2,1,1,pass
3855,1,True,39,4,43,2,1,pass
3856,1,True,26,5,31,4,1,pass
3857,1,True,47,44,91,14,1,pass
3858,1,True,6,3,9,3,1,pass
3859,1,True,32,26,58,5,1,fail
3860,1,True,34,10,44,3,1,pass
3861,1,False,69,40,109,1,1,pass
3862,1,True,695,483,1178,27,1,pass
3863,1,True,3,3,6,3,1,pass
3864,1,False,12,0,12,1,1,pass
3865,1,True,1,1,2,1,1,pass
3866,1,True,104,3,107,3,2,pass
3867,2,False,101,68,169,5,3,pass
3868,1,False,2,2,4,1,1,pass
3871,1,False,68,101,169,5,3,pass
3872,1,True,16,24,40,1,1,pass
3873,1,True,11,0,11,1,1,pass
3874,1,True,35,1,36,4,3,pass
3875,1,True,16,0,16,2,1,pass
3876,1,True,36,0,36,2,1,pass
3877,1,False,1,0,1,1,1,pass
3878,2,False,130,78,208,15,5,fail
3879,1,True,101,68,169,5,3,pass
3880,1,True,2,2,4,1,1,pass
3881,1,True,4,4,8,3,1,pass
3882,1,True,20,4,24,2,1,pass
3883,1,True,2,1,3,1,1,pass
3884,2,True,2,3,5,1,1,pass
3885,1,True,2,3,5,1,1,pass
3886,2,True,20,2,22,4,2,pass
3887,1,True,2,13,15,3,3,pass
3888,1,True,6,7,13,2,1,pass
3891,2,True,1,1,2,1,1,pass
3892,2,True,1,1,2,1,1,pass
3893,1,True,1,1,2,1,1,pass
3894,1,False,9,3,12,3,3,pass
3895,1,False,11,3,14,1,1,pass
3896,1,False,19,0,19,3,1,fail
3897,1,False,37,1,38,2,1,pass
3898,1,False,3,3,6,2,1,pass
3899,1,True,1,1,2,1,1,pass
3900,1,True,165,3,168,5,2,pass
3901,1,False,35,33,68,2,2,pass
3902,1,False,1,1,2,1,1,fail
3903,1,False,1,1,2,1,1,fail
3904,1,False,5,6,11,3,1,pass
3905,1,False,82,22,104,9,2,pass
3906,1,False,0,12,12,2,1,pass
3907,1,False,0,7,7,1,1,pass
3908,1,True,402,62,464,5,2,pass
3909,1,True,1,1,2,1,1,pass
3910,1,True,81,13,94,6,2,pass
3911,1,True,123,22,145,6,2,pass
3912,1,True,707,394,1101,30,5,pass
3913,1,True,660,172,832,20,5,pass
3914,1,False,37,1,38,2,1,pass
3915,1,False,13,0,13,1,1,pass
3916,1,True,1,0,1,1,1,pass
3917,1,False,25,3,28,2,2,pass
3919,1,False,152,5,157,1,1,pass
3921,1,False,61,32,93,3,1,pass
3922,1,False,1,0,1,1,1,fail
3924,2,False,149,55,204,26,4,fail
3925,1,True,891,144,1035,8,2,pass
3926,1,False,33,10,43,2,1,fail
3927,1,False,17,13,30,2,1,fail
3928,1,False,1,1,2,1,1,pass
3929,1,False,5,4,9,3,3,pass
3930,1,False,53,47,100,1,1,pass
3932,1,False,2,2,4,1,1,fail
3935,1,False,23,24,47,2,2,fail
3936,1,True,1,1,2,1,1,pass
3937,1,True,74,14,88,5,3,pass
3938,1,True,4,1,5,1,1,pass
3939,1,True,47,33,80,17,1,pass
3940,1,True,56,27,83,14,2,pass
3941,1,True,36,15,51,3,2,pass
3942,1,True,66,2,68,10,4,pass
3943,1,True,390,22,412,6,4,pass
3944,1,True,38,3,41,2,1,pass
3945,1,True,1,1,2,1,1,pass
3946,2,False,1,1,2,1,1,pass
3947,1,True,1,1,2,1,1,pass
3948,1,False,2,2,4,2,2,pass
3950,1,False,23,19,42,1,1,pass
3952,1,False,1,1,2,1,1,pass
3953,1,True,69,20,89,10,4,fail
3954,1,False,18,1,19,3,2,pass
3955,1,True,41,0,41,8,4,pass
3956,1,False,63,21,84,5,2,pass
3957,1,True,136,104,240,14,4,pass
3958,1,False,5,2,7,3,3,pass
3959,1,False,4,4,8,1,1,pass
3960,1,False,8,8,16,1,1,pass
3961,1,True,997,51,1048,34,8,pass
3962,1,False,4,4,8,1,1,pass
3963,1,False,80,35,115,1,1,fail
3965,1,False,5,4,9,3,3,pass
3966,1,False,57,106,163,1,1,pass
3967,1,False,150,65,215,2,2,fail
3968,1,False,3,0,3,1,1,pass
3969,1,False,17,2,19,4,3,pass
3970,1,True,12,1,13,2,1,pass
3971,1,True,7,0,7,2,1,pass
3972,1,True,3,3,6,1,1,pass
3973,1,True,1,1,2,1,1,pass
3974,1,False,4,2,6,2,1,pass
3975,1,False,339,217,556,34,3,pass
3977,1,False,19,15,34,2,2,pass
3979,2,False,388,59,447,20,6,pass
3980,1,False,5,4,9,3,3,pass
3981,1,False,12,23,35,1,1,pass
3982,1,False,83,1,84,8,4,fail
3983,1,False,8,1,9,2,2,pass
3984,1,True,26,1,27,2,1,pass
3985,1,True,1,1,2,1,1,pass
3986,1,False,5,4,9,3,3,pass
3987,1,False,8,85,93,3,2,pass
3988,1,False,5,4,9,3,3,pass
3989,1,False,309,22,331,9,3,pass
3990,1,False,2,2,4,2,1,fail
3991,1,False,13,2,15,4,2,fail
3992,1,True,5,0,5,1,1,pass
3994,2,False,958,339,1297,49,11,pass
3995,1,True,1,1,2,1,1,pass
3996,1,False,1,1,2,1,1,pass
3998,1,False,22,3,25,3,3,pass
3999,1,True,7,7,14,1,1,pass
4000,1,False,0,1,1,1,1,pass
4001,1,False,1,1,2,1,1,pass
4002,1,False,28,20,48,1,1,pass
4007,1,False,92,0,92,2,1,pass
4008,1,False,144,160,304,7,2,pass
4009,1,False,20,4,24,3,1,pass
4010,1,False,108,15,123,7,2,pass
4011,1,False,4,5,9,1,1,pass
4012,1,False,4,19,23,1,1,fail
4013,1,False,23,33,56,4,1,fail
4015,1,False,186,16,202,7,3,fail
4016,1,True,1,1,2,1,1,pass
4017,1,True,42,0,42,3,2,pass
4018,1,True,1,1,2,1,1,pass
4019,1,True,38,2,40,3,1,pass
4020,1,True,1,1,2,1,1,pass
4021,1,True,10,0,10,1,1,fail
4022,1,True,12,6,18,1,1,pass
4023,1,True,6,1,7,1,1,pass
4024,1,True,4,4,8,2,1,pass
4025,1,False,26,9,35,2,1,pass
4026,2,False,177,128,305,11,5,pass
4027,1,False,159,125,284,8,4,pass
4028,1,False,4,4,8,1,1,pass
4029,1,False,7,6,13,2,1,fail
4030,1,True,16,2,18,2,1,pass
4031,1,True,2,1,3,1,1,pass
4032,1,False,1,1,2,1,1,fail
4033,1,False,2,2,4,2,2,pass
4035,2,False,827,208,1035,60,10,pass
4036,1,False,5,4,9,3,3,pass
4037,1,False,97,64,161,2,2,pass
4038,1,False,202,4,206,29,7,pass
4039,1,False,13,5,18,3,1,pass
4040,1,False,136,103,239,7,2,fail
4041,1,False,110,1,111,7,4,pass
4042,1,False,30,1,31,3,2,pass
4043,1,False,44,3,47,5,2,pass
4044,1,False,128,2,130,6,3,pass
4045,1,True,1606,167,1773,32,3,pass
4046,1,True,14,0,14,1,1,pass
4047,1,True,1,1,2,1,1,pass
4048,1,True,1,1,2,1,1,pass
4049,1,True,1,1,2,1,1,pass
4050,1,True,3,2,5,1,1,fail
4051,1,True,4,3,7,1,1,fail
4052,1,True,2,2,4,1,1,fail
4053,1,True,1,1,2,1,1,pass
4054,1,False,1,1,2,1,1,pass
4056,1,True,771,794,1565,70,4,pass
4057,1,False,2,2,4,2,2,fail
4058,1,False,79,1,80,3,1,fail
4059,1,False,2,2,4,2,2,pass
4060,1,False,14,1,15,1,1,pass
4061,1,True,474,27,501,5,2,pass
4062,1,True,684,2,686,10,2,pass
4063,2,False,1182,187,1369,50,8,pass
4064,1,False,7,1,8,1,1,pass
4065,1,False,132,15,147,10,5,fail
4066,1,True,1,1,2,1,1,pass
4067,1,False,5,4,9,3,3,pass
4068,1,False,1,1,2,1,1,pass
4069,1,False,27,4,31,2,1,pass
4070,1,False,100,31,131,8,2,fail
4071,1,False,35,20,55,10,2,fail
4072,1,False,13,3,16,2,2,pass
4073,1,True,20,20,40,8,1,pass
4074,1,False,5,4,9,3,3,pass
4075,1,False,4,4,8,1,1,pass
4076,1,False,687,16,703,9,4,pass
4077,1,False,125,67,192,6,2,pass
4078,1,False,1,0,1,1,1,pass
4079,1,True,1,1,2,1,1,pass
4080,1,True,1,1,2,1,1,pass
4081,1,True,1,1,2,1,1,fail
4082,1,False,22,1,23,4,2,pass
4084,1,False,2,0,2,1,1,pass
4085,1,False,3,1,4,1,1,pass
4086,1,False,4,0,4,1,1,fail
4088,1,False,5,4,9,3,3,pass
4089,1,False,6,6,12,1,1,pass
4090,1,False,1,0,1,1,1,pass
4091,1,False,3,13,16,1,1,pass
4092,1,True,9,2,11,2,1,fail
4093,1,False,16,15,31,2,1,fail
4094,1,False,2,2,4,2,1,pass
4095,1,False,123,0,123,5,4,pass
4096,1,False,15,1,16,3,2,pass
4097,1,False,23,4,27,4,2,pass
4098,1,False,2,1,3,1,1,pass
4099,1,False,3,3,6,3,3,pass
4101,1,False,57,3,60,5,4,pass
4102,1,False,2,1,3,2,2,pass
4103,1,False,10,7,17,2,1,pass
4104,1,False,1,1,2,1,1,fail
4106,1,False,18,16,34,3,1,fail
4107,1,False,44,30,74,8,4,fail
4108,1,True,4,1,5,1,1,fail
4109,1,False,694,424,1118,18,5,fail
4110,1,False,2,2,4,1,1,pass
4111,1,False,177,6,183,9,5,fail
4112,1,False,11,11,22,1,1,pass
4113,1,False,11,8,19,1,1,pass
4114,1,False,49,1,50,4,3,fail
4115,1,False,409,7,416,4,2,pass
4116,1,False,5,4,9,3,3,pass
4117,1,False,17,1,18,1,1,pass
4119,1,False,1,0,1,1,1,pass
4120,1,True,1,12,13,1,1,pass
4121,1,True,108,2,110,4,3,pass
4122,1,False,175,21,196,7,2,pass
4123,1,False,11,24,35,1,1,pass
4124,1,False,24,5,29,3,2,pass
4126,1,False,20,1,21,2,2,pass
4127,1,False,1751,81,1832,23,5,fail
4128,1,False,4,4,8,1,1,fail
4129,1,True,1,1,2,1,1,pass
4130,1,False,5,4,9,3,3,pass
4133,1,False,1,59,60,1,1,pass
4135,1,False,131,8,139,1,1,fail
4136,1,False,1293,12,1305,18,4,pass
4137,1,False,38,2,40,6,4,pass
4138,1,False,13,5,18,2,1,pass
4139,1,False,39,0,39,3,2,pass
4140,1,False,63,3,66,7,2,pass
4141,1,False,20,20,40,7,2,pass
4142,1,False,13,2,15,2,2,pass
4143,1,False,5,4,9,3,3,pass
4144,1,False,9,0,9,1,1,pass
4145,1,False,4,7,11,2,2,pass
4146,1,False,43,8,51,4,2,pass
4147,1,False,11,11,22,1,1,pass
4148,1,False,5,4,9,3,3,pass
4149,1,False,41,3,44,3,2,fail
4151,1,True,1,1,2,1,1,fail
4152,1,False,18,3,21,3,2,fail
4153,1,True,3,3,6,3,1,fail
4154,1,False,2,1,3,2,2,fail
4156,1,False,15,9,24,1,1,fail
4158,1,False,87,7,94,6,2,fail
4159,1,False,117,8,125,5,3,fail
4160,1,False,5,4,9,3,3,fail
4161,1,False,2,1,3,2,2,fail
4162,1,False,11,1,12,2,2,fail
4163,1,False,13,6,19,1,1,fail
4164,1,False,3,2,5,1,1,fail
4165,1,False,2,2,4,2,2,fail
4166,1,False,8,1,9,2,2,fail
4167,1,False,5,4,9,3,3,fail
4168,1,False,0,1,1,1,1,fail
4169,2,False,181,101,282,34,4,fail
4170,1,False,2,2,4,2,2,fail
4171,1,False,1,1,2,1,1,fail
4172,1,False,2,2,4,2,2,fail
4173,1,False,13,15,28,1,1,pass
4174,1,False,52,33,85,9,2,pass
4175,1,False,4,3,7,3,2,pass
4176,1,False,2,1,3,2,2,pass
4177,1,False,2,1,3,1,1,pass
4178,1,False,9,5,14,1,1,pass
4179,1,False,5,5,10,3,1,pass
4180,1,False,21,5,26,3,2,pass
4181,1,False,1,1,2,1,1,pass
4182,1,False,3,1,4,1,1,pass
4183,1,False,2,0,2,1,1,fail
4184,1,False,50,2,52,4,1,fail
4185,1,False,25,9,34,2,2,pass
4186,1,False,64,21,85,8,4,pass
4187,1,False,39,35,74,3,2,pass
4188,1,False,39,0,39,8,2,pass
4189,1,True,2,2,4,1,1,pass
4190,1,False,6,6,12,1,1,pass
4192,1,True,26,0,26,3,2,pass
4193,1,True,93,2,95,4,2,pass
4194,1,True,22,1,23,2,1,pass
4195,1,True,1,1,2,1,1,fail
4196,2,False,9,9,18,5,1,pass
4198,1,True,1,1,2,1,1,pass
4199,1,True,42,41,83,19,3,fail
4200,1,False,2,1,3,1,1,pass
4203,1,False,12,8,20,3,3,pass
4204,1,False,21,9,30,2,1,pass
4205,1,False,94,25,119,8,3,fail
4206,1,False,124,7,131,8,4,pass
4207,1,False,5,5,10,2,2,pass
4208,1,False,6,6,12,1,1,pass
4209,1,False,1,1,2,1,1,pass
4210,1,False,137,4,141,10,6,fail
4211,1,False,23,14,37,3,2,pass
4212,1,False,94,17,111,7,1,pass
4213,1,True,47,47,94,20,1,pass
4214,1,False,1,0,1,1,1,pass
4215,1,True,6,0,6,3,2,pass
4216,1,False,18,4,22,8,3,pass
4217,1,False,61,8,69,8,3,pass
4218,1,True,8,8,16,4,1,pass
4219,1,False,40,1,41,2,1,pass
4220,1,False,1,0,1,1,1,pass
4221,1,False,4,3,7,1,1,pass
4222,1,False,2,2,4,2,2,pass
4223,1,False,8,3,11,2,1,pass
4225,1,True,3065,844,3909,67,4,pass
4226,1,False,8,3,11,2,1,pass
4227,1,True,43,34,77,8,3,fail
4228,1,False,1,0,1,1,1,pass
4229,1,False,1,2,3,1,1,fail
4230,1,False,106,9,115,5,2,fail
4231,1,False,94,15,109,4,1,fail
4232,1,True,11,0,11,1,1,fail
4233,1,True,1,1,2,1,1,fail
4234,1,False,2,2,4,2,2,fail
4235,1,False,7,3,10,1,1,fail
4236,1,False,48,29,77,3,3,fail
4237,1,False,2,2,4,1,1,fail
4238,1,False,6,2,8,1,1,fail
4239,1,False,1,1,2,1,1,fail
4240,1,False,128,10,138,8,2,fail
4241,1,False,10,3,13,1,1,fail
4242,1,False,6,2,8,2,1,fail
4243,1,False,2,2,4,2,2,pass
4244,1,False,44,11,55,1,1,fail
4245,1,False,1,1,2,1,1,fail
4246,1,False,2,2,4,2,2,fail
4247,1,False,2,2,4,1,1,pass
4248,1,False,15,1,16,1,1,pass
4249,1,True,18,2,20,1,1,pass
4250,1,True,130,1,131,7,4,pass
4251,1,True,48,25,73,4,1,pass
4252,1,True,1843,236,2079,11,8,pass
4253,1,False,2,2,4,2,2,pass
4254,1,False,24,24,48,2,1,pass
4255,1,True,1,1,2,1,1,pass
4256,1,True,24,2,26,2,1,pass
4257,1,True,1,1,2,1,1,pass
4258,1,True,1,1,2,1,1,pass
4259,2,False,109,20,129,13,4,pass
4260,1,False,5,4,9,3,3,pass
4261,1,False,1,0,1,1,1,pass
4263,1,False,2,2,4,2,2,pass
4264,1,True,1,1,2,1,1,pass
4265,1,False,2,1,3,1,1,pass
4266,1,False,18,1,19,3,2,fail
4267,1,False,58,67,125,2,1,pass
4268,1,True,590,531,1121,33,1,pass
4269,1,True,135,24,159,4,1,fail
4270,1,False,2,1,3,2,2,pass
4271,1,False,65,8,73,6,1,pass
4272,2,False,38,0,38,3,2,pass
4273,1,False,38,0,38,3,2,pass
4274,1,False,55,65,120,1,1,pass
4275,1,False,65,55,120,1,1,pass
4276,2,False,1,1,2,1,1,pass
4277,1,False,1,1,2,1,1,fail
4279,1,False,5,4,9,3,3,pass
4280,1,False,1,0,1,1,1,pass
4281,1,False,42,2,44,3,2,pass
4282,1,False,42,11,53,2,1,pass
4283,1,False,2,1,3,2,2,pass
4284,1,False,389,13,402,11,6,fail
4286,1,True,62,22,84,4,1,pass
4287,1,False,5,4,9,3,3,pass
4324,1,True,78,6,84,7,3,pass
4325,1,True,42,55,97,3,1,pass
4326,1,False,5,4,9,3,3,pass
4327,1,False,5,1,6,1,1,pass
4328,1,True,2,2,4,1,1,pass
4329,1,False,2,2,4,2,1,pass
4330,1,True,1,1,2,1,1,fail
4331,1,True,11,0,11,1,1,fail
4332,1,True,2,2,4,1,1,fail
4333,1,True,1,1,2,1,1,pass
4334,1,False,3,0,3,1,1,pass
4335,1,True,3,3,6,1,1,pass
4336,1,True,1,1,2,1,1,fail
4337,1,True,1,1,2,1,1,pass
4338,1,True,3,0,3,1,1,fail
4339,1,True,4,4,8,1,1,pass
4340,1,True,1,1,2,1,1,pass
4341,1,False,11,1,12,1,1,pass
4342,1,False,48,17,65,1,1,pass
4343,1,False,1,0,1,1,1,fail
4345,1,True,61,17,78,7,3,pass
4346,1,False,11,2,13,2,2,pass
4347,1,False,63,2,65,8,4,pass
4348,1,False,38,2,40,3,2,pass
4349,1,False,5,0,5,1,1,pass
4350,1,False,8,1,9,2,2,pass
4351,1,True,70,4087,4157,58,2,pass
4352,1,False,5,4,9,3,3,pass
4353,1,False,1,0,1,1,1,pass
4354,1,False,83,53,136,6,3,pass
4355,1,False,1,1,2,1,1,pass
4356,1,True,43,1,44,2,1,pass
4357,1,False,31,1,32,3,2,pass
4358,1,False,1,1,2,1,1,pass
4359,1,False,3,3,6,1,1,fail
4360,1,False,3,4,7,1,1,fail
4361,1,False,5,4,9,3,3,fail
4362,1,False,75,3,78,3,2,fail
4363,1,False,4,3,7,2,2,fail
4364,1,False,13,2,15,1,1,pass
4365,1,False,9,1,10,2,1,fail
4366,1,False,26,3,29,6,3,pass
4367,1,False,17,4,21,3,2,pass
4368,1,False,1,5,6,1,1,pass
4369,1,False,14,6,20,4,2,pass
4370,1,False,8,8,16,1,1,pass
4371,1,False,37,26,63,7,3,fail
4372,2,False,338,0,338,8,2,pass
4373,1,False,11,0,11,2,2,pass
4374,1,False,19,16,35,2,1,fail
4375,1,False,119,0,119,1,1,fail
4376,1,False,6,0,6,1,1,fail
4377,1,False,4,4,8,2,1,fail
4378,1,False,210,0,210,8,2,fail
4379,1,True,3,1,4,1,1,pass
4380,1,False,11,6,17,3,2,pass
4381,1,False,138,30,168,3,2,fail
4382,1,False,1,1,2,1,1,pass
4383,1,False,51,0,51,3,1,pass
4384,1,False,0,2,2,1,1,pass
4385,1,False,1,0,1,1,1,fail
4386,1,False,4,1,5,1,1,fail
4387,1,False,1,0,1,1,1,fail
4388,1,False,2,3,5,2,2,fail
4389,1,False,2,2,4,1,1,fail
4390,1,False,2,0,2,1,1,fail
4391,1,False,26,15,41,3,1,fail
4392,1,False,22,22,44,5,1,fail
4395,1,False,7,5,12,1,1,fail
4396,1,False,2,0,2,1,1,pass
4397,2,False,86,60,146,8,2,pass
4398,1,True,39,54,93,1,1,pass
4399,1,True,1,1,2,1,1,pass
4400,1,False,1,0,1,1,1,pass
4401,1,True,1,1,2,1,1,pass
4402,1,True,1,1,2,1,1,pass
4403,1,True,35,19,54,3,2,pass
4404,1,False,1,0,1,1,1,pass
4405,1,True,46,0,46,3,1,pass
4406,1,False,175,10,185,12,2,pass
4407,1,False,1,1,2,1,1,pass
4408,1,False,2,2,4,2,2,pass
4409,1,False,45,0,45,2,2,pass
4410,1,False,10,2,12,2,2,pass
4411,1,False,18,0,18,3,2,pass
4412,1,True,2,2,4,1,1,pass
4413,1,True,19,0,19,1,1,pass
4414,1,False,5,1,6,3,1,pass
4415,1,False,2,2,4,1,1,pass
4416,1,False,2,2,4,1,1,fail
4417,1,False,1,0,1,1,1,fail
4418,1,False,60,4,64,4,3,fail
4419,1,False,60,40,100,4,2,pass
4420,1,False,6,1,7,2,2,pass
4421,1,True,1,1,2,1,1,pass
4422,1,False,2,2,4,2,2,pass
4423,1,False,29,18,47,6,3,pass
4424,1,False,83,3,86,2,1,pass
4425,1,False,2,2,4,2,2,pass
4426,1,False,4,4,8,2,1,pass
4427,1,False,538,108,646,23,7,fail
4428,1,False,1,1,2,1,1,pass
4429,1,True,20,0,20,1,1,fail
4430,1,True,1,1,2,1,1,fail
4431,1,True,3,1,4,1,1,fail
4432,1,False,15,4,19,2,1,pass
4433,1,False,49,0,49,2,1,pass
4434,1,False,1,0,1,1,1,pass
4435,1,False,14,2,16,2,1,pass
4436,1,False,2,2,4,2,2,pass
4437,1,False,9,18,27,2,2,pass
4438,1,False,1,1,2,1,1,fail
4439,1,False,2,2,4,2,2,fail
4440,1,False,9,2,11,2,2,pass
4441,1,False,81,9,90,2,1,pass
4442,1,False,0,10,10,1,1,pass
4443,1,False,5,0,5,2,2,fail
4444,1,False,20,2,22,3,2,pass
4445,1,False,2,6,8,1,1,pass
4446,1,False,4,1,5,1,1,fail
4449,1,False,5,4,9,3,3,pass
4450,1,False,1,0,1,1,1,pass
4451,1,False,13,2,15,3,1,pass
4452,1,False,3,1,4,3,2,pass
4453,1,False,7,0,7,2,2,pass
4454,1,False,274,31,305,7,4,pass
4455,1,False,7,1,8,2,2,pass
4456,1,False,4,4,8,1,1,pass
4457,1,False,6,4,10,3,1,fail
4458,1,False,5,1,6,2,2,pass
4459,1,False,25,9,34,2,2,pass
4461,1,False,5,4,9,3,3,pass
4462,1,False,29,1,30,4,2,pass
4463,1,False,84,16,100,5,3,pass
4464,1,False,15,1,16,1,1,pass
4465,1,False,12,1,13,2,2,pass
4466,1,False,4,1,5,1,1,pass
4467,1,False,1,0,1,1,1,pass
4468,1,False,2,0,2,1,1,pass
4469,1,False,146,152,298,9,3,pass
4470,1,False,0,0,0,1,1,pass
4471,1,False,1,0,1,1,1,pass
4472,1,False,5600,5599,11199,195,4,pass
4475,1,True,1,1,2,1,1,pass
4476,1,True,1,1,2,1,1,pass
4477,1,True,1,1,2,1,1,pass
4478,1,False,21,2,23,3,2,pass
4479,1,False,5,4,9,3,3,pass
4480,1,False,18,21,39,3,1,pass
4481,1,False,18,1,19,4,2,pass
4482,1,False,404,7,411,7,3,pass
4483,1,False,7,7,14,3,3,pass
4485,1,False,80,8,88,6,2,pass
4487,1,False,23,2,25,3,1,pass
4488,1,False,39,0,39,5,3,pass
4489,1,False,2,2,4,2,2,pass
4490,1,False,4,4,8,1,1,pass
4491,1,False,48,26,74,4,2,pass
4492,1,False,47,11,58,1,1,pass
4493,1,False,1,2,3,2,2,pass
4494,1,False,53,0,53,4,2,pass
4495,1,False,1,0,1,1,1,pass
4496,1,False,62,16,78,11,4,pass
4497,1,False,26,0,26,1,1,pass
4498,1,False,214,47,261,4,2,pass
4499,1,False,2,2,4,2,2,pass
4500,1,False,134,0,134,6,3,pass
4501,1,False,8,1,9,2,1,pass
4502,1,False,210,70,280,7,3,fail
4503,1,False,146,3,149,5,2,pass
4504,1,False,45,10,55,4,2,pass
4506,1,True,16,2,18,1,1,pass
4507,1,False,28,2,30,4,2,pass
4508,1,False,4,0,4,1,1,pass
4509,1,False,14,2,16,3,2,pass
4510,1,False,81,37,118,9,3,pass
4511,1,False,557,140,697,14,3,pass
4512,1,False,2,2,4,2,2,pass
4513,1,False,7,1,8,1,1,pass
4514,1,False,4,1,5,2,1,fail
4515,1,False,575,9,584,4,2,fail
4516,1,False,59,1,60,3,2,pass
4517,1,False,4,1,5,2,2,pass
4518,1,False,133,65,198,5,1,pass
4520,1,False,5,4,9,3,3,pass
4521,1,False,8,0,8,1,1,pass
4523,1,False,14,6,20,3,1,pass
4524,1,True,8,6,14,1,1,pass
4525,1,True,2,2,4,1,1,pass
4526,1,False,2,2,4,2,1,pass
4527,1,False,23,2,25,3,1,pass
4528,1,False,5,3,8,1,1,pass
4529,1,False,2,2,4,2,2,pass
4530,1,False,7,0,7,1,1,pass
4531,1,False,1,1,2,1,1,pass
4532,1,False,6,2,8,1,1,pass
4533,1,False,227,3624,3851,92,1,pass
4534,1,False,14,5,19,5,1,pass
4535,1,False,6,6,12,2,1,fail
4536,1,False,4321,1830,6151,89,3,fail
4537,1,True,8,8,16,2,1,pass
4538,1,False,5,4,9,3,3,pass
4539,1,False,38,0,38,4,1,pass
4540,1,False,2,1,3,1,1,pass
4541,1,False,11,8,19,6,3,pass
4542,1,False,140,2,142,5,3,pass
4543,1,False,10,2,12,3,2,pass
4544,1,False,2,2,4,2,2,pass
4545,1,False,27,1,28,2,1,pass
4546,1,True,27,19,46,4,2,pass
4547,1,False,4,4,8,3,2,pass
4548,1,False,329,16,345,16,5,fail
4549,1,False,4,3,7,4,1,pass
4550,1,False,65,6,71,4,2,fail
4551,1,True,6,4,10,2,1,pass
4552,1,False,18,1,19,3,2,pass
4553,1,False,0,1,1,1,1,pass
4554,1,False,43,33,76,3,2,pass
4555,1,False,3,3,6,2,1,pass
4556,1,False,253,18,271,15,4,fail
4557,1,False,2,2,4,2,2,pass
4559,1,False,6,2,8,2,2,fail
4560,1,False,2,2,4,2,2,pass
4561,1,False,92,62,154,10,2,pass
4562,1,False,2,10,12,2,2,pass
4563,1,False,0,2,2,1,1,pass
4564,1,False,92,4,96,4,2,pass
4565,1,False,3,1,4,2,2,pass
4566,1,False,9,1,10,2,1,fail
4567,1,False,22,6,28,4,2,fail
4568,1,False,2,0,2,1,1,fail
4569,1,False,2,1,3,1,1,fail
4570,1,False,4,0,4,1,1,fail
4571,1,False,2,2,4,1,1,fail
4572,1,False,275,123,398,12,3,fail
4573,1,False,33,4,37,4,3,pass
4574,1,False,0,5,5,1,1,pass
4575,1,False,0,1,1,1,1,pass
4577,1,False,2,2,4,2,1,pass
4578,1,False,16,4,20,5,2,fail
4580,1,False,5,4,9,3,3,pass
4581,1,False,9,2,11,2,2,pass
4582,1,False,232,13,245,8,3,pass
4583,1,False,1,2,3,1,1,pass
4584,1,False,62,0,62,3,1,pass
4585,1,True,11,4,15,1,1,pass
4586,1,True,1,2,3,1,1,pass
4587,1,True,3,2,5,1,1,pass
4588,1,False,132,41,173,12,2,pass
4589,1,False,50,7,57,3,1,pass
4590,1,False,73,1,74,4,2,pass
4591,1,False,5,4,9,3,3,pass
4592,1,False,16,5,21,2,2,pass
4593,1,False,2,2,4,2,2,pass
4594,1,False,8,1,9,2,2,fail
4595,1,True,1,1,2,1,1,fail
4596,1,False,5,1,6,2,2,pass
4597,1,False,5,4,9,3,3,pass
4598,1,False,7,3,10,4,2,pass
4599,1,False,3,1,4,2,2,pass
4600,1,False,161,79,240,3,1,pass
4601,1,False,1,1,2,1,1,pass
4602,1,False,61,8,69,3,2,pass
4604,1,False,96,0,96,4,2,pass
4606,1,False,2,2,4,1,1,pass
4607,1,False,5,4,9,3,3,pass
4608,1,False,1,1,2,1,1,pass
4610,1,False,5,4,9,3,3,pass
4611,1,False,2,2,4,1,1,pass
4612,1,False,0,0,0,2,2,fail
4613,1,False,11,0,11,2,2,fail
4614,1,False,8,13,21,2,1,pass
4615,1,False,73,25,98,7,2,pass
4618,1,False,45,16,61,6,4,pass
4619,1,False,5,4,9,3,3,pass
4620,1,False,9,6,15,3,2,pass
4621,1,False,4,4,8,1,1,pass
4622,1,False,2,2,4,2,2,fail
4625,1,False,46,24,70,1,1,fail
4626,1,False,5,4,9,3,3,pass
4627,1,False,57,1,58,1,1,pass
4629,1,False,143,3,146,4,2,pass
4630,1,False,178,0,178,4,2,pass
4631,1,False,18,0,18,2,2,pass
4632,1,False,13,2,15,3,1,pass
4633,1,False,2,2,4,1,1,pass
4634,1,False,267,26,293,5,2,pass
4635,1,False,7,1,8,2,1,pass
4637,1,True,6,6,12,2,2,pass
4638,1,False,2,2,4,2,2,pass
4639,1,False,1,0,1,1,1,pass
4640,1,False,325,25,350,20,7,fail
4641,1,False,2052,2,2054,20,4,pass
4643,1,False,10,6,16,4,2,pass
4644,1,False,2,1,3,1,1,pass
4645,1,False,61,7,68,7,2,fail
4646,1,False,111,39,150,12,2,pass
4647,1,False,286,3,289,4,3,pass
4648,1,False,1,1,2,1,1,pass
4649,1,False,1,1,2,1,1,fail
4650,1,False,1,0,1,1,1,fail
4651,1,False,0,1,1,1,1,pass
4655,1,False,2,2,4,1,1,fail
4656,1,False,2,1,3,1,1,fail
4657,1,False,1,1,2,1,1,fail
4658,1,False,85,11,96,3,2,fail
4659,1,False,1,2,3,1,1,pass
4660,1,False,2,2,4,1,1,pass
4661,1,False,1,1,2,1,1,fail
4662,1,False,14,0,14,1,1,fail
4663,1,False,651,491,1142,86,5,fail
4664,1,False,7,1,8,1,1,pass
4665,1,False,24,2,26,3,3,pass
4666,1,False,5,4,9,3,3,pass
4667,1,False,10,1,11,2,2,pass
4668,1,False,5,4,9,3,3,pass
4669,1,False,29,4,33,1,1,pass
4670,1,False,1,1,2,1,1,pass
4671,1,False,6,3,9,1,1,pass
4672,1,False,93,5,98,7,2,pass
4673,1,False,2,2,4,2,2,pass
4674,1,False,2220,8,2228,18,4,fail
4675,1,False,26,29,55,3,2,pass
4676,1,False,6,10,16,1,1,pass
4677,1,False,20,20,40,2,1,pass
4678,1,False,1,1,2,1,1,pass
4679,1,False,4,4,8,1,1,pass
4680,1,False,1,1,2,1,1,pass
4681,1,False,287,4,291,3,2,pass
4682,1,False,2,2,4,2,2,pass
4683,1,False,1,1,2,1,1,pass
4684,1,False,2,2,4,2,2,pass
4685,1,False,1,1,2,1,1,pass
4687,1,False,185,2,187,9,2,pass
4689,1,False,2,2,4,1,1,pass
4690,1,False,38,21,59,2,1,pass
4691,1,False,2,4,6,1,1,pass
4692,1,False,4,0,4,1,1,pass
4694,1,False,40,5,45,4,2,pass
4696,1,False,38,11,49,6,2,pass
4697,1,False,49,49,98,22,2,pass
4698,1,False,53,1,54,3,2,pass
4699,1,False,8,5,13,2,1,pass
4700,1,False,309,270,579,2,1,pass
4701,1,False,3,1,4,1,1,pass
4704,1,False,11,3,14,5,2,pass
4705,1,False,43,17,60,6,2,pass
4706,1,False,1,1,2,1,1,pass
4707,1,True,3,3,6,1,1,pass
4708,1,False,5,4,9,3,3,pass
4709,1,False,143,43,186,11,2,pass
4710,1,True,2,2,4,1,1,pass
4711,1,False,5,4,9,3,3,pass
4712,1,False,2,2,4,2,2,pass
4713,1,False,7,0,7,2,2,pass
4714,1,False,51,24,75,4,3,pass
4715,1,False,58,0,58,4,2,pass
4716,1,False,15,4,19,2,2,pass
4717,1,False,2,2,4,1,1,pass
4718,1,False,5,4,9,3,3,pass
4719,1,False,3,2,5,2,2,pass
4720,1,False,2,2,4,2,2,pass
4721,1,False,8,2,10,1,1,pass
4722,1,False,2,2,4,2,2,pass
4723,1,False,16,9,25,1,1,pass
4724,1,False,2,2,4,2,2,pass
4726,1,False,2,2,4,2,2,pass
4727,1,False,1,1,2,1,1,pass
4728,1,False,2,2,4,2,2,pass
4730,1,False,2,0,2,1,1,fail
4731,1,False,3,1,4,1,1,fail
4732,1,False,1,1,2,1,1,fail
4733,1,False,2,2,4,1,1,fail
4734,1,False,21,0,21,1,1,fail
4735,1,False,2,2,4,2,2,pass
4736,1,False,2,17,19,2,2,pass
4737,1,False,2,2,4,2,2,pass
4738,1,False,9,1,10,2,2,pass
4739,1,False,99,43,142,5,2,pass
4740,1,False,5,4,9,3,3,pass
4741,1,False,1,0,1,1,1,pass
4742,1,False,13,0,13,1,1,pass
4743,1,True,1,1,2,1,1,pass
4744,1,False,4,0,4,1,1,pass
4745,1,False,1361,183,1544,21,3,pass
4746,1,False,6,4,10,3,3,pass
4747,1,False,56,32,88,3,2,pass
4748,1,False,40,4,44,5,3,pass
4749,1,False,5,4,9,3,3,pass
4750,1,False,1,1,2,1,1,pass
4751,1,False,0,839,839,1,1,pass
4752,1,False,35,0,35,2,1,pass
4753,1,False,3,3,6,2,2,pass
4754,1,False,75,50,125,9,2,pass
4755,1,False,353,4,357,13,4,pass
4756,1,False,13,13,26,6,1,pass
4757,1,False,112,1,113,4,2,pass
4758,1,False,1,1,2,1,1,pass
4759,1,False,0,2,2,1,1,pass
4760,1,False,12,2,14,1,1,fail
4761,1,False,142,34,176,6,2,pass
4764,1,False,2,6,8,2,2,pass
4765,1,False,3,152,155,3,2,fail
4766,1,False,5,1,6,2,2,fail
4767,1,False,1,1,2,1,1,pass
4768,1,False,7,2,9,1,1,fail
4769,1,False,317,150,467,26,2,fail
4770,1,False,1,1,2,1,1,pass
4771,1,False,6,5,11,3,3,pass
4772,1,False,39,2,41,4,2,pass
4773,1,False,2,2,4,2,2,pass
4774,1,False,10,3,13,3,2,pass
4775,1,False,292,16,308,13,3,pass
4776,1,False,61,35,96,6,1,pass
4777,1,False,34,4,38,5,2,fail
4778,1,False,2,2,4,2,2,pass
4779,1,False,649,11,660,9,3,pass
4780,1,False,19,2,21,3,2,pass
4781,1,False,11,0,11,2,2,pass
4782,1,False,540,51,591,21,5,pass
4783,1,False,70,14,84,3,2,pass
4784,1,False,137,0,137,7,5,pass
4785,1,False,1,1,2,1,1,pass
4786,1,False,5,4,9,2,2,fail
4787,1,False,10,1,11,2,2,fail
4788,1,False,0,0,0,1,1,pass
4789,1,False,1,1,2,1,1,pass
4790,1,False,11,3,14,3,3,pass
4791,1,False,5,1,6,1,1,pass
4792,1,False,1,0,1,1,1,fail
4793,1,False,3,2,5,1,1,pass
4794,1,False,2,2,4,2,2,pass
4795,1,False,8,2,10,1,1,pass
4796,1,False,11,22,33,2,2,pass
4797,1,False,2,59,61,3,3,pass
4798,1,False,135,16,151,3,3,pass
4799,1,False,63,74,137,1,1,pass
4802,1,False,439,266,705,8,2,pass
4803,1,False,3,1,4,1,1,pass
4804,1,False,1,1,2,1,1,fail
4805,1,False,9,1,10,2,2,fail
4807,1,False,200,0,200,5,2,pass
4808,1,False,6,1,7,1,1,pass
4810,1,False,549,20,569,20,3,pass
4811,1,False,63,20,83,11,2,pass
4813,1,False,196,23,219,8,4,pass
4815,1,False,16,29,45,1,1,pass
4816,1,False,48,18,66,4,1,pass
4818,1,False,223,23,246,10,3,pass
4819,1,False,3672,79,3751,18,5,pass
4820,1,False,398,21,419,15,5,pass
4821,1,False,8,0,8,1,1,pass
4823,1,False,532,113,645,13,3,pass
4825,1,False,1,1,2,1,1,pass
4826,1,False,6,6,12,2,2,pass
4827,1,False,803,6,809,6,5,pass
4828,1,False,3,3,6,1,1,pass
4829,1,False,1,1,2,1,1,pass
4830,1,False,1,1,2,1,1,pass
4831,1,False,1,1,2,1,1,pass
4832,1,False,6,4,10,4,2,fail
4833,1,False,1,1,2,1,1,fail
4834,1,False,58,2,60,3,3,fail
4836,1,False,10,0,10,4,1,pass
4837,1,False,42,12,54,5,1,fail
4838,1,False,322,49,371,17,4,pass
4839,1,False,21,12,33,1,1,pass
4840,1,False,3835,133,3968,54,3,pass
4841,1,False,263,5,268,9,2,pass
4842,1,False,107,3,110,6,3,pass
4843,1,False,7,0,7,1,1,pass
4844,1,False,5,0,5,1,1,pass
4846,1,False,3,2,5,1,1,pass
4847,1,False,2,2,4,2,2,pass
4848,1,False,1,0,1,1,1,pass
4851,1,False,320,31,351,18,2,pass
4852,1,False,342,18,360,14,3,pass
4853,1,False,248,34,282,11,2,pass
4855,1,False,17,0,17,1,1,pass
4856,1,False,48,47,95,2,1,pass
4857,1,False,10,0,10,1,1,fail
4885,2,True,1597,1222,2819,27,1,pass
4886,1,True,0,8,8,1,1,pass
4887,2,True,1286,1285,2571,4,2,pass
4888,1,True,1,1,2,1,1,fail
4889,2,True,283,51,334,19,1,pass
4890,2,True,58,7,65,4,1,pass
4891,1,True,283,51,334,19,1,fail
4892,2,True,11,7,18,2,1,pass
4893,1,True,11,7,18,2,1,pass
4894,1,True,47,0,47,2,1,pass
4895,1,True,4,4,8,2,1,pass
4896,2,True,2,2,4,2,1,pass
4897,1,True,1,1,2,1,1,pass
4899,1,False,3,2,5,1,1,pass
4900,2,True,78,0,78,4,1,pass
4901,1,True,78,0,78,4,1,pass
4902,2,True,22,0,22,4,1,pass
4903,1,True,7,15,22,1,1,pass
4905,1,True,22,0,22,4,1,fail
4906,1,True,226,24,250,7,2,pass
4907,2,True,0,0,0,0,0,pass
4908,1,True,226,24,250,7,2,pass
4909,2,True,669,88,757,32,2,pass
4910,2,True,7,2,9,3,3,pass
4911,1,True,9,7,16,3,1,pass
4913,1,True,662,83,745,31,2,pass
4914,1,True,5,0,5,1,1,pass
4915,1,True,2,2,4,2,2,pass
4916,2,True,441,68104,68545,77,4,pass
4917,1,True,7,79076,79083,63,4,pass
4918,1,True,38,1,39,2,1,pass
4919,1,True,40,46,86,5,1,pass
4920,1,True,5,0,5,1,1,pass
4921,1,True,1,1,2,1,1,pass
4922,1,True,208,25,233,3,1,pass
4924,2,True,11324,137,11461,14,2,pass
4925,1,True,11090,9,11099,6,2,pass
4926,1,True,234,128,362,8,1,pass
4927,2,True,1511,201,1712,30,2,pass
4928,2,True,0,0,0,0,0,pass
4929,1,True,1,1,2,1,1,pass
4930,1,True,1320,195,1515,27,2,pass
4931,2,True,190,5,195,5,1,pass
4932,1,True,190,5,195,5,1,pass
4933,2,True,1848,17,1865,32,2,pass
4934,2,True,1,4,5,1,1,pass
4935,1,True,1,1,2,1,1,pass
4936,1,True,7,0,7,5,1,pass
4937,2,True,1079,17,1096,21,2,fail
4938,1,True,1079,17,1096,21,2,pass
4939,2,True,768,6,774,14,2,pass
4940,1,True,768,6,774,14,2,pass
4941,1,False,1,4,5,1,1,pass
4942,2,True,211,7,218,14,2,pass
4943,1,True,2,0,2,1,1,pass
4944,2,True,5,1,6,2,1,pass
4945,1,True,5,1,6,2,1,pass
4946,1,True,1,1,2,1,1,pass
4947,1,True,164,0,164,9,1,pass
4948,2,True,7,1,8,1,1,pass
4949,2,True,32,4,36,2,1,pass
4950,2,True,32,4,36,2,1,pass
4951,1,True,1,2,3,1,1,pass
4952,1,True,14,6,20,1,1,pass
4953,1,True,24,3,27,2,1,pass
4954,1,True,4,4,8,1,1,pass
4955,1,True,7,5,12,1,1,fail
4956,1,True,5,1,6,1,1,fail
4958,1,True,1,1,2,1,1,fail
4959,2,True,428,11,439,17,1,pass
4960,1,True,1,1,2,1,1,pass
4961,2,True,243,2,245,6,1,pass
4962,1,True,175,91,266,3,1,pass
4963,1,True,14,0,14,1,1,pass
4964,1,True,143,0,143,4,1,pass
4965,2,True,99,11,110,4,1,pass
4966,1,True,99,11,110,4,1,pass
4967,2,True,42,4,46,3,1,pass
4968,1,True,1,1,2,1,1,pass
4969,1,True,42,4,46,3,1,fail
4970,2,True,52,2,54,5,1,pass
4971,1,True,52,2,54,5,1,pass
4972,1,True,1,1,2,1,1,pass
4973,1,True,3,0,3,1,1,pass
4974,2,True,0,0,0,0,0,pass
4975,1,True,3,0,3,1,1,fail
4976,2,True,441,396,837,58,1,pass
4977,2,True,0,0,0,0,0,pass
4978,1,True,7,1,8,1,1,pass
4979,1,True,394,393,787,54,1,pass
4980,1,True,40,2,42,4,1,pass
4981,2,True,1107,554,1661,91,3,pass
4982,2,True,0,0,0,0,0,pass
4983,1,True,4,1,5,2,1,pass
4984,1,True,366,204,570,26,3,pass
4985,1,True,17,1,18,2,1,pass
4986,1,True,300,263,563,49,1,pass
4987,1,True,501,228,729,28,3,pass
4988,1,True,68,14,82,7,1,pass
4989,1,True,2,0,2,2,1,pass
4990,1,True,10,4,14,4,1,pass
4991,2,True,3051,81,3132,41,4,pass
4992,1,True,15,0,15,1,1,pass
4993,2,True,0,0,0,0,0,pass
4994,1,True,74,6,80,9,1,fail
4995,1,True,2837,70,2907,28,4,pass
4996,1,True,65,1,66,5,1,pass
4997,1,True,6,2,8,3,1,pass
4998,1,True,66,14,80,7,2,pass
4999,2,True,16,5,21,6,1,pass
5000,2,True,0,0,0,0,0,pass
5001,1,True,13,3,16,4,1,fail
5002,1,True,3,2,5,2,1,pass
5003,2,True,1318,68,1386,54,3,pass
5004,2,True,0,0,0,0,0,pass
5005,1,True,1,1,2,1,1,fail
5006,1,True,439,41,480,24,1,pass
5007,1,True,218,4,222,9,1,pass
5008,1,True,7,5,12,5,1,pass
5009,1,True,11,7,18,2,1,pass
5010,1,True,4,3,7,3,2,pass
5011,1,True,75,9,84,6,1,pass
5012,1,True,536,10,546,18,2,pass
5013,1,True,40,1,41,4,1,pass
5014,2,True,1072,562,1634,76,2,pass
5015,2,True,0,0,0,0,0,pass
5016,1,True,10,7,17,3,1,pass
5017,1,True,2,0,2,1,1,pass
5018,1,True,30,17,47,6,1,pass
5019,1,True,449,397,846,47,1,pass
5020,1,True,145,125,270,44,1,pass
5021,1,True,13,25,38,1,1,pass
5022,1,True,24,0,24,2,1,pass
5023,1,True,128,13,141,9,2,pass
5024,1,True,35,2,37,2,1,pass
5025,1,True,48,9,57,5,2,pass
5026,1,True,198,0,198,1,1,pass
5027,1,True,3,0,3,1,1,pass
5028,1,True,26,0,26,1,1,pass
5029,2,True,1322,294,1616,49,4,pass
5030,2,True,0,0,0,0,0,pass
5031,1,True,195,53,248,9,2,pass
5032,1,True,346,23,369,5,1,pass
5033,1,True,337,181,518,17,2,pass
5034,1,True,36,2,38,4,1,pass
5035,1,True,32,6,38,2,2,pass
5036,1,True,15,0,15,2,1,pass
5037,1,True,150,14,164,5,1,pass
5038,1,True,25,10,35,9,1,pass
5039,1,True,154,13,167,15,2,pass
5040,1,True,39,1,40,2,1,pass
5041,1,True,2,0,2,1,1,pass
5042,2,True,21177,1159,22336,133,7,pass
5043,1,True,39,1,40,3,2,pass
5044,1,True,68,20,88,7,3,pass
5045,1,True,39,45,84,31,2,pass
5046,1,True,91,8,99,6,2,pass
5047,2,True,839,1,840,4,2,pass
5048,1,True,822,67,889,4,2,pass
5049,1,True,84,1,85,3,2,pass
5050,1,True,17,4,21,1,1,pass
5051,1,True,94,2,96,5,1,pass
5052,1,True,266,262,528,3,1,pass
5053,1,True,12173,0,12173,4,2,pass
5054,1,True,76,47,123,22,1,pass
5055,1,True,6,11,17,3,1,pass
5056,1,True,158,86,244,29,2,pass
5057,1,True,36,24,60,6,1,pass
5058,1,True,6125,206,6331,56,3,pass
5059,1,True,178,0,178,7,1,pass
5060,1,True,21,17,38,4,1,pass
5061,1,True,740,435,1175,10,2,pass
5062,1,True,49,1,50,2,1,pass
5063,1,True,96,41,137,21,1,pass
5064,1,True,8,8,16,1,1,pass
5065,1,True,76,426,502,30,1,pass
5066,1,True,41,8,49,3,1,pass
5067,1,True,138,48,186,10,4,pass
5068,1,True,139,0,139,6,1,pass
5069,1,True,150,1,151,6,1,pass
5070,1,True,29,18,47,7,1,pass
5071,1,True,39,39,78,12,1,pass
5072,1,True,50,4,54,4,1,pass
5073,1,False,29,1,30,1,1,pass
5074,1,False,9,5,14,2,2,pass
5075,1,False,34,2,36,2,1,fail
5076,1,False,11,2,13,1,1,pass
5077,1,False,6,6,12,1,1,pass
5078,1,False,16,16,32,4,1,fail
5079,1,False,8,7,15,3,2,pass
5080,1,False,1,1,2,1,1,pass
5081,1,False,6,6,12,1,1,fail
5082,1,False,128,5,133,23,1,fail
5083,1,False,400,52,452,25,1,pass
5084,1,False,1,0,1,1,1,pass
5085,1,False,107,7,114,8,1,pass
5086,2,False,4,0,4,1,1,pass
5088,1,True,4,0,4,1,1,pass
5089,1,False,28,2,30,3,1,pass
5090,1,False,30,12,42,2,1,pass
5091,1,False,3,8,11,1,1,pass
5092,1,False,52,1,53,2,1,pass
5093,1,False,13,1,14,1,1,pass
5094,1,False,4,3,7,1,1,pass
5095,1,False,6,1,7,2,1,pass
5096,1,False,16,7,23,3,1,fail
5097,1,False,15,20,35,9,1,pass
5098,1,False,45,7,52,4,2,pass
5099,1,False,1,1,2,1,1,pass
5100,1,False,0,1,1,1,1,pass
5101,1,False,3,0,3,1,1,fail
5102,1,False,19,27,46,11,4,fail
5103,1,False,5,4,9,3,2,fail
5104,1,False,15,7096,7111,53,5,fail
5105,1,False,3,1,4,1,1,fail
5106,1,False,16,11,27,3,1,fail
5107,1,False,3,2,5,3,1,fail
5108,1,False,1,1,2,1,1,fail
5109,1,True,94,75,169,5,1,fail
5110,1,True,76,23,99,4,1,fail
5111,1,False,1,0,1,1,1,fail
5112,1,False,2,0,2,1,1,fail
5113,1,False,5,3,8,1,1,fail
5114,1,False,27,13,40,1,1,fail
5115,1,False,14,3,17,2,2,fail
5116,1,False,8,1,9,2,1,fail
5118,1,True,100,41,141,3,1,fail
5119,1,False,2,1,3,1,1,fail
5120,1,False,6,3,9,1,1,fail
5121,1,False,1,0,1,1,1,fail
5122,1,False,4,2,6,1,1,fail
5124,2,False,1,1,2,1,1,fail
5126,2,False,1,1,2,1,1,fail
5128,2,False,2,0,2,1,1,fail
5130,2,False,193,0,193,2,1,fail
5131,1,False,1,0,1,1,1,fail
5133,2,False,91,47,138,8,3,fail
5135,1,False,1,1,2,1,1,fail
5136,1,False,76,44,120,4,1,fail
5137,1,False,15,2,17,3,2,fail
5138,1,False,1,1,2,1,1,fail
5139,2,False,23,10,33,3,1,fail
5141,1,True,23,10,33,3,1,fail
5142,1,False,1,0,1,1,1,fail
5143,1,False,36,9,45,3,1,fail
5144,1,False,41,37,78,1,1,fail
5145,1,False,40,17501,17541,67,7,fail
6370,1,False,25,81,106,4,1,pass
6371,1,False,65,5,70,4,2,pass
6372,1,False,143,22,165,2,1,pass
6373,1,False,144,4,148,2,1,pass
6374,1,False,36,0,36,1,1,pass
6375,1,False,16,19,35,3,1,pass
6376,1,False,245,0,245,4,1,pass
6377,1,False,272,0,272,3,1,pass
6378,1,False,1,1,2,1,1,pass
6379,1,False,14,31,45,5,1,pass
6380,1,False,5,5,10,1,1,pass
6381,1,False,128,8,136,2,1,pass
6382,1,False,4,0,4,2,1,pass
6383,1,False,1,1,2,1,1,pass
6384,1,False,33,1,34,2,1,pass
6385,1,False,0,1,1,1,1,pass
6386,1,False,0,426,426,2,1,pass
6387,1,False,1,1,2,1,1,fail
6388,1,False,18,3,21,2,1,fail
6389,1,False,0,8,8,1,1,fail
6390,1,False,8,0,8,1,1,fail
6391,1,False,615,82,697,10,2,fail
6392,1,False,8,0,8,1,1,fail
6393,1,False,254,0,254,3,1,fail
6394,1,False,5,0,5,1,1,fail
6395,1,False,82,10,92,4,2,fail
6396,1,False,356,11,367,10,2,fail
6397,1,False,59,9,68,4,2,fail
6398,1,False,1,0,1,1,1,fail
6399,1,False,174,107,281,3,1,fail
6400,1,False,55,0,55,2,1,pass
6401,1,False,38,1,39,2,2,pass
6402,1,False,64,16,80,4,1,pass
6403,1,False,1136,5,1141,5,1,pass
6404,1,False,12,10,22,3,1,pass
6405,1,False,3,0,3,1,1,pass
6406,1,False,53,136,189,2,1,pass
6407,1,False,1,1,2,1,1,pass
6408,1,False,3,1,4,1,1,pass
6409,1,False,30,3,33,2,1,pass
6410,1,True,2,0,2,1,1,fail
6411,1,False,6,21,27,1,1,pass
6412,1,False,4,3,7,1,1,pass
6413,1,False,140,4,144,4,1,pass
6414,1,False,286,1,287,2,1,pass
6415,1,False,2,2,4,1,1,pass
6416,1,False,1,1,2,1,1,pass
6417,1,False,620,0,620,3,1,pass
6418,1,False,92,12,104,2,1,pass
6419,1,False,1,2,3,1,1,pass
6420,1,False,937,0,937,5,1,pass
6421,1,False,641,0,641,5,1,pass
6422,1,True,1033,229,1262,29,13,pass
6423,1,False,4,1,5,1,1,pass
6424,1,False,0,177,177,1,1,pass
6425,1,False,2,5,7,1,1,fail
6426,1,False,3,0,3,2,1,pass
6427,1,False,76,5,81,2,1,fail
6428,1,False,94,6,100,4,1,fail
6429,1,False,882,0,882,5,1,fail
6430,1,False,307,142,449,4,1,fail
6431,1,False,135,15,150,4,1,pass
6432,1,False,17,2,19,1,1,pass
6433,1,False,4,0,4,1,1,pass
6434,1,False,197,109,306,16,2,pass
6435,1,False,6,3,9,2,1,pass
6436,1,False,59,0,59,2,2,pass
6437,1,False,38,24,62,3,1,pass
6438,1,False,26,8,34,1,1,pass
6439,1,False,2,2,4,1,1,pass
6440,1,False,142,62,204,3,1,pass
6441,1,False,247,13,260,4,1,pass
6442,1,False,21,11,32,2,1,pass
6443,1,False,16,22,38,1,1,pass
6444,1,False,0,2,2,1,1,pass
6445,1,False,1,0,1,1,1,pass
6446,1,False,35,27,62,3,1,pass
6447,1,False,1083,40,1123,4,1,pass
6448,1,False,18,0,18,2,1,fail
6449,1,False,27,35,62,3,1,fail
6450,1,False,35,27,62,3,1,fail
6451,1,False,4,4,8,1,1,fail
6452,1,False,11,0,11,2,1,pass
6453,1,False,7,1,8,1,1,fail
6454,1,False,101,99,200,2,1,fail
6455,1,False,8,8,16,1,1,fail
6456,1,False,25,19,44,12,2,fail
6457,1,False,23,4,27,3,1,fail
6458,1,False,4,4,8,4,1,fail
6459,1,False,15,4,19,2,1,fail
6460,1,False,369,99,468,6,1,fail
6461,1,False,18,14,32,4,1,fail
6462,1,False,62,2,64,5,2,fail
6463,1,False,17,10,27,2,1,fail
6464,1,False,615,12,627,2,1,fail
6465,1,False,4,3,7,1,1,pass
6466,1,False,5,8,13,4,1,pass
6467,1,False,86,21,107,3,1,pass
6468,1,False,2,2,4,1,1,pass
6469,1,False,309,106,415,6,1,pass
6470,1,False,3,0,3,1,1,pass
6471,1,False,161,168,329,3,1,pass
6472,1,False,22,22,44,2,1,pass
6473,1,False,0,34,34,14,2,pass
6474,1,False,484,421,905,6,2,pass
6475,1,False,134,7,141,4,1,pass
6476,1,False,47,21,68,5,1,pass
6477,1,False,2,2,4,1,1,pass
6478,1,False,0,0,0,3,1,pass
6479,1,False,24,7,31,2,1,pass
6480,1,False,142,22,164,6,1,pass
6481,1,False,10,2,12,2,1,pass
6482,1,False,2,1,3,1,1,pass
6483,1,False,313,175,488,7,1,pass
6484,1,False,1,1,2,1,1,pass
6485,1,False,13,11,24,3,1,pass
6486,1,False,2,2,4,1,1,pass
6487,1,False,4,16,20,1,1,fail
6488,1,False,88,65,153,4,2,pass
6489,1,False,3,3,6,1,1,pass
6490,1,False,211,125,336,6,1,pass
6491,1,False,0,4,4,1,1,fail
6492,1,True,2406,1407,3813,93,27,pass
6493,1,False,1,1,2,1,1,pass
6494,1,False,394,1,395,6,1,pass
6495,1,False,157,59,216,3,1,fail
6496,1,False,0,1,1,1,1,pass
6497,1,False,12,8,20,1,1,pass
6498,1,False,2,15,17,2,1,pass
6499,1,False,9,17,26,5,1,pass
6500,1,False,56,5,61,2,1,pass
6501,1,False,2,2,4,4,1,fail
6502,1,False,79,46,125,7,1,pass
6503,1,False,36,14,50,2,1,pass
6504,1,False,47,23,70,7,1,pass
6505,1,False,28,1,29,2,1,pass
6506,1,False,12,5,17,2,1,pass
6507,1,False,3,0,3,1,1,pass
6508,1,False,19,18,37,3,1,pass
6509,1,False,214,22,236,12,2,pass
6510,1,False,336,156,492,7,1,pass
6511,1,False,3,1,4,1,1,pass
6512,1,False,142,3,145,5,2,pass
6513,1,False,38,17,55,2,1,pass
6514,1,False,3,1,4,2,1,fail
6515,1,False,23,4,27,2,1,pass
6516,1,False,12,8,20,1,1,pass
6517,1,False,458,7,465,4,2,pass
6518,1,False,7,0,7,1,1,fail
6519,1,False,20,16,36,4,1,pass
6520,1,False,6,0,6,1,1,pass
6521,1,False,1085,9,1094,10,1,pass
6522,1,False,0,34,34,8,1,pass
6523,1,False,54,9,63,2,1,pass
6524,1,False,203,161,364,14,1,pass
6525,1,False,184,3,187,5,2,pass
6526,1,False,210,118,328,9,1,pass
6527,1,False,1,1,2,1,1,pass
6528,1,False,1,259,260,65,1,pass
6530,1,False,42,9,51,1,1,pass
6531,1,False,866,17,883,13,2,pass
6532,1,False,2,1,3,1,1,pass
6533,1,False,398,225,623,14,1,pass
6534,1,False,4,1,5,1,1,pass
6535,1,False,23,34,57,4,1,pass
6536,1,False,8,4,12,1,1,pass
6537,1,False,832,0,832,4,1,fail
6538,1,False,72,6,78,3,2,pass
6539,1,False,2,2,4,1,1,pass
6540,1,True,69,84,153,1,1,pass
6541,1,False,13,2,15,4,1,pass
6542,1,False,6,3,9,1,1,pass
6543,1,False,38,2,40,1,1,pass
6544,1,False,14,17,31,3,1,pass
6545,1,False,2,2,4,1,1,fail
6546,1,False,130,40,170,6,2,pass
6547,1,False,13,21,34,7,1,pass
6548,1,False,14,4,18,4,1,pass
6549,1,False,354,30,384,2,1,pass
6550,1,False,5,0,5,1,1,pass
6551,1,False,7,4,11,1,1,pass
6552,1,True,5,4,9,1,1,fail
6553,1,False,30,26,56,1,1,fail
6554,1,False,17,197,214,7,1,fail
6555,1,False,3,0,3,1,1,fail
6556,1,False,7,1,8,1,1,fail
6557,1,False,16,4,20,1,1,pass
6558,1,False,256,9,265,6,1,fail
6559,1,False,2,0,2,1,1,pass
6560,1,False,387,0,387,5,1,pass
6561,1,False,2,2,4,1,1,fail
6562,1,False,70,14,84,3,1,pass
6563,1,False,0,2,2,1,1,pass
6564,1,False,209,205,414,7,1,pass
6565,1,False,53,1,54,2,1,fail
6566,1,False,31,38,69,4,1,fail
6567,1,False,7,0,7,1,1,fail
6568,1,False,2,2,4,2,1,pass
6569,1,False,7,5,12,2,1,fail
6570,1,False,1,1,2,1,1,fail
6571,1,False,11,5,16,4,2,pass
6572,1,False,360,0,360,4,1,fail
6573,1,False,9,6,15,2,1,fail
6574,1,False,38,7,45,4,1,pass
6575,1,False,5,3,8,1,1,fail
6576,1,False,261,249,510,28,1,fail
6577,2,True,1658,80,1738,19,2,fail
6578,1,False,341,0,341,3,1,fail
6579,1,False,289,209,498,9,1,pass
6580,1,False,1,2,3,1,1,pass
6581,1,False,4,1,5,1,1,pass
6582,1,False,1,1,2,1,1,fail
6583,1,False,1,1,2,1,1,pass
6584,1,False,175,0,175,1,1,pass
6585,1,False,81,42,123,3,1,pass
6586,1,False,136,11,147,3,2,pass
6587,1,False,282,13,295,9,2,pass
6588,1,False,2,1,3,1,1,pass
6589,1,False,15,3,18,1,1,pass
6590,1,False,12,2,14,2,1,pass
6591,1,False,3,3,6,1,1,pass
6592,1,False,1,3,4,2,1,pass
6593,1,False,1,1,2,1,1,pass
6594,1,False,1,1,2,1,1,pass
6595,1,False,2,0,2,1,1,pass
6596,1,False,6,0,6,1,1,pass
6597,1,True,77,82,159,5,2,pass
6598,1,False,295,5,300,5,1,pass
6599,1,False,8,5,13,2,1,pass
6600,1,False,5,4,9,1,1,pass
6601,1,False,65,98,163,4,1,pass
6602,1,True,62,11,73,2,1,pass
6603,1,False,11,1,12,2,1,pass
6604,1,False,737,0,737,3,2,fail
6605,1,False,6,2,8,1,1,fail
6606,1,False,612,397,1009,12,2,pass
6607,1,False,41,14,55,1,1,fail
6608,1,False,48,19,67,2,1,pass
6609,1,False,186,18,204,6,3,pass
6610,1,False,39,11,50,2,1,pass
6611,1,False,92,87,179,3,1,pass
6612,1,False,437,2,439,6,1,pass
6613,1,False,133,48,181,1,1,pass
6614,1,False,5,0,5,1,1,pass
6615,1,False,12,10,22,3,1,pass
6616,1,True,48,2,50,3,1,pass
6617,1,False,66,64,130,5,1,pass
6618,1,False,2863,0,2863,11,1,pass
6619,1,False,110,30,140,5,1,pass
6620,1,False,54,3,57,5,1,pass
6621,1,False,222,2,224,1,1,pass
6622,1,False,1,5,6,1,1,fail
6623,1,False,1,2,3,1,1,pass
6624,1,False,1,1,2,1,1,pass
6625,1,False,242,211,453,5,1,pass
6626,1,False,2,2,4,2,1,fail
6627,1,False,738,483,1221,12,1,pass
6628,1,False,16,23,39,11,1,pass
6629,1,True,85,92,177,1,1,pass
6630,1,True,16,13,29,3,1,pass
6631,1,True,5,6,11,2,2,pass
6632,1,True,0,0,0,1,1,pass
6633,1,True,178,223,401,2,1,pass
6634,1,False,264,321,585,5,1,pass
6635,1,True,8,15,23,3,2,pass
6636,1,True,19,16,35,2,2,pass
6637,1,False,5,3,8,1,1,pass
6638,1,True,134,5,139,4,2,pass
6639,2,True,10110,4285,14395,213,9,pass
6640,1,False,24,12,36,2,1,pass
6641,1,True,1459,68,1527,15,1,pass
6642,1,False,34,8,42,1,1,pass
6643,1,False,52,10,62,1,1,pass
6644,1,False,31,0,31,2,1,pass
6645,1,False,65,24,89,4,2,pass
6646,1,True,25,0,25,1,1,pass
6647,1,False,26,22,48,8,2,pass
6648,1,False,8,7,15,3,1,pass
6649,1,False,33,11,44,1,1,pass
6650,1,False,200,0,200,4,1,pass
6651,1,False,5,11,16,2,1,pass
6652,1,False,38,11,49,2,1,pass
6653,1,False,158,58,216,3,1,pass
6654,1,False,4,4,8,1,1,pass
6655,1,False,209,108,317,7,1,pass
6656,1,False,6,1,7,1,1,pass
6657,1,False,8,0,8,1,1,pass
6658,1,False,1129,0,1129,4,2,pass
6659,1,False,3,7,10,1,1,pass
6660,1,True,14,0,14,1,1,pass
6661,1,False,858,7,865,5,1,pass
6662,1,False,1,0,1,1,1,pass
6663,1,False,14,15,29,5,2,pass
6664,1,False,38,2,40,1,1,pass
6665,1,False,2,4,6,1,1,pass
6666,1,False,0,18,18,5,1,pass
6667,1,False,49,11,60,2,1,pass
6668,1,False,5,9,14,3,1,pass
6669,1,False,1,1,2,1,1,pass
6670,1,False,56,47,103,5,1,pass
6671,1,False,13,0,13,1,1,pass
6672,1,False,2,2,4,1,1,pass
6673,1,True,1,1,2,1,1,pass
6674,1,True,1,1,2,1,1,pass
6675,1,True,1,1,2,1,1,pass
6676,1,False,5,16,21,1,1,pass
6677,1,False,164,101,265,4,2,pass
6678,1,False,0,6,6,2,1,fail
6679,1,False,419,24,443,4,2,fail
6680,1,False,835,0,835,5,1,fail
6681,1,False,46,136,182,2,1,pass
6682,1,False,6,10,16,1,1,pass
6683,1,False,352,38,390,4,1,pass
6684,1,False,16,3,19,3,1,pass
6685,1,False,3,3,6,1,1,pass
6686,1,False,476,0,476,3,1,pass
6687,1,False,2,2,4,1,1,pass
6688,1,False,73,11,84,4,1,pass
6689,1,False,1,36,37,2,1,pass
6690,1,False,1,0,1,1,1,pass
6691,1,False,6,4,10,1,1,pass
6692,1,False,471,4,475,3,1,pass
6693,1,False,21,11,32,3,1,pass
6694,1,False,36,33,69,1,1,fail
6695,1,False,64,51,115,2,1,pass
6696,1,True,11,12,23,1,1,fail
6697,1,False,70,0,70,2,2,pass
6698,1,False,1,1,2,1,1,pass
6699,1,False,21,10,31,2,1,pass
6700,1,False,24,8,32,4,1,pass
6701,1,False,0,9,9,2,1,pass
6702,1,False,7,0,7,1,1,pass
6703,1,False,4,1,5,1,1,pass
6704,1,False,195,4,199,4,1,pass
6705,1,False,11,5,16,1,1,pass
6706,1,False,246,5,251,2,1,pass
6707,2,True,332,1,333,4,1,pass
6708,1,True,62,6,68,4,2,pass
6709,1,False,296,0,296,4,4,pass
6710,1,False,21,0,21,1,1,pass
6711,1,False,475,354,829,4,1,pass
6712,1,False,3,4,7,3,1,pass
6713,1,False,0,2436,2436,13,1,pass
6714,1,False,4,4,8,3,1,fail
6715,1,False,1,1,2,1,1,fail
6716,1,False,9,15,24,5,1,fail
6717,1,False,21,5,26,1,1,fail
6718,1,False,286,318,604,25,1,fail
6719,1,False,1,7,8,1,1,fail
6720,1,False,34,3,37,2,1,fail
6721,1,False,613,121,734,27,1,fail
6722,1,False,25,23,48,6,1,fail
6723,1,False,44,15,59,2,1,fail
6724,1,False,4,4,8,5,1,fail
6725,1,False,2,2,4,1,1,fail
6726,1,False,125,6,131,6,1,fail
6727,1,False,15,46,61,3,1,fail
6728,1,False,55,6,61,2,1,fail
6729,1,False,123,1,124,2,1,fail
6730,1,False,25,38,63,2,1,fail
6731,1,True,12,7,19,1,1,fail
6732,1,False,1,1,2,1,1,fail
6733,1,False,202,0,202,2,1,fail
6734,1,False,17,0,17,1,1,pass
6735,1,False,141,54,195,14,1,fail
6736,1,False,529,7,536,8,2,fail
6737,1,False,4,5,9,1,1,fail
6738,1,False,2,1,3,1,1,fail
6739,1,False,96,74,170,4,1,pass
6740,1,False,86,44,130,1,1,fail
6741,1,False,12,1,13,1,1,fail
6742,1,False,1,1,2,1,1,fail
6743,1,False,1,1,2,1,1,fail
6744,1,False,5,5,10,1,1,pass
6745,1,False,75,12,87,3,1,fail
6746,1,False,51,1,52,2,1,fail
6747,1,False,4,4,8,5,1,fail
6748,1,False,5,2,7,1,1,fail
6749,1,False,14,0,14,1,1,pass
6750,1,False,0,261,261,2,1,pass
6751,1,True,39,0,39,1,1,fail
6752,1,False,56,0,56,2,1,fail
6753,1,False,21,4,25,4,1,fail
6754,1,False,4,4,8,2,1,fail
6755,1,True,374,50,424,7,2,fail
6756,1,False,1,1,2,1,1,fail
6757,1,False,3,3,6,2,2,fail
6758,1,True,71,19,90,5,2,fail
6759,1,False,231,11,242,9,1,fail
6760,1,False,6,4,10,1,1,fail
6761,1,False,1,0,1,1,1,fail
6762,1,False,761,0,761,7,2,fail
6763,2,False,8,1,9,2,2,fail
6764,1,False,0,95,95,1,1,fail
6765,1,False,181,10,191,5,1,fail
6766,1,False,21310,1,21311,110,3,fail
6767,1,False,1,1,2,1,1,pass
6768,1,False,107,7,114,5,2,pass
6769,1,False,315,0,315,3,1,pass
6770,1,False,202,88,290,12,1,pass
6771,1,True,3,3,6,1,1,pass
6772,1,False,1,1,2,1,1,pass
6773,1,False,1,1,2,1,1,pass
6774,1,False,4,4,8,1,1,pass
6775,1,False,53,18,71,5,1,pass
6776,1,False,31,2,33,2,1,pass
6777,1,False,42,42,84,1,1,pass
6778,1,False,28,9,37,2,1,fail
6779,1,False,3,2,5,1,1,fail
6780,1,False,6,5,11,1,1,fail
6781,1,False,13,9,22,4,1,fail
6782,1,False,37,15,52,5,1,fail
6783,1,False,30,11,41,3,1,fail
6784,1,False,63,64,127,16,1,fail
6785,1,False,287,234,521,7,1,fail
6786,1,False,7,6,13,1,1,pass
6787,1,False,5,2,7,1,1,fail
6788,1,False,57,4,61,4,1,fail
6789,2,True,600,10,610,4,2,fail
6790,1,False,34,0,34,1,1,fail
6791,1,False,79,1,80,5,1,fail
6792,1,False,26,431,457,3,1,fail
6793,1,False,0,1,1,1,1,fail
6794,1,False,4,42,46,1,1,fail
6795,1,False,5,0,5,1,1,pass
6796,1,True,8977,0,8977,69,22,fail
6797,1,False,1,1,2,1,1,fail
6798,1,True,4,121,125,2,2,pass
6799,1,True,7,4,11,2,1,pass
6800,1,True,64,66,130,3,1,pass
6801,1,True,46,90,136,5,2,pass
6802,1,True,7,8,15,3,1,pass
6803,1,True,144,13,157,3,1,pass
6804,1,True,125,20,145,2,1,pass
6805,1,False,199,39,238,5,2,fail
6806,1,False,4,4,8,1,1,fail
6809,1,False,8,6,14,1,1,fail
6812,1,False,4,6,10,1,1,fail
6813,1,False,27,6,33,1,1,fail
6814,1,False,536,0,536,4,1,fail
6816,1,True,83,33,116,7,3,fail
6818,1,False,351,17,368,5,1,fail
6820,1,False,336,0,336,2,1,fail
6822,1,False,43,23,66,6,1,fail
6823,1,False,46,3,49,2,1,fail
6825,1,False,28,4,32,3,1,fail
6827,1,False,0,5,5,1,1,fail
6830,1,False,5,5,10,1,1,fail
6831,1,False,19,19,38,2,2,fail
6834,1,False,778,3,781,5,2,fail
6836,1,False,79,0,79,1,1,fail
6837,1,False,19,6,25,2,1,pass
6840,1,False,65,34,99,5,1,fail
6841,1,False,0,2,2,1,1,fail
6843,1,False,2,1,3,1,1,pass
6844,1,True,37,37,74,1,1,pass
6845,1,False,8,3,11,1,1,pass
6846,1,False,14,10,24,4,1,pass
6848,1,False,3,0,3,1,1,pass
6849,1,False,5,2,7,2,2,pass
6850,1,False,189,8,197,5,1,pass
6852,1,False,292,266,558,3,1,pass
6854,1,True,118,0,118,1,1,pass
6855,1,True,59,46,105,3,1,pass
6857,1,False,4,117,121,27,1,pass
6859,1,False,0,329,329,2,1,pass
6861,1,False,29,20,49,3,1,fail
6863,1,False,10,7,17,2,1,fail
6864,1,True,0,1,1,1,1,pass
6865,1,True,5,7,12,2,1,pass
6866,1,True,126,123,249,1,1,pass
6867,1,True,25,14,39,2,1,pass
6869,1,False,329,0,329,2,1,fail
6870,1,True,0,403,403,1,1,pass
6871,1,False,2,2,4,1,1,pass
6873,1,False,4,0,4,1,1,pass
6874,1,True,16,0,16,1,1,pass
6876,1,False,6,6,12,3,1,pass
6878,1,False,7,7,14,1,1,pass
6879,1,True,0,3,3,1,1,pass
6881,1,False,397,2,399,8,2,pass
6883,1,False,1,1,2,1,1,pass
6884,1,True,400,107,507,7,1,pass
6885,2,True,2,2,4,1,1,pass
6887,1,False,1,1,2,1,1,pass
6888,1,True,2,2,4,1,1,pass
6890,2,True,14,4,18,1,1,pass
6891,1,False,1,1,2,1,1,pass
6894,1,False,2,6,8,1,1,fail
6896,1,False,10,2,12,2,1,fail
6897,1,True,6,36,42,1,1,pass
6898,1,True,12,79,91,1,1,pass
6900,1,False,1,1,2,1,1,fail
6901,1,True,0,7,7,1,1,pass
6902,1,True,139,61,200,2,1,pass
6903,1,True,187,17,204,2,1,pass
6904,1,True,10,4,14,1,1,fail
6906,1,False,1,1,2,1,1,fail
6907,1,True,0,0,0,0,0,pass
6909,2,True,95,0,95,1,1,pass
6910,1,False,7,0,7,1,1,fail
6912,1,False,1,3,4,1,1,pass
6914,1,True,74,74,148,3,1,fail
6916,1,False,3,0,3,1,1,fail
6917,1,True,54,78,132,4,1,fail
6918,1,True,13,15,28,1,1,fail
6920,1,False,16,5,21,2,1,fail
6921,1,False,5,7,12,3,2,fail
6923,1,False,8,6,14,1,1,fail
6925,1,False,457,0,457,6,1,fail
6926,1,True,406,49,455,14,1,fail
6927,1,True,97,0,97,1,1,fail
6929,2,True,770,0,770,2,1,fail
6930,1,False,16,10,26,3,1,fail
6932,1,False,30,8,38,3,2,pass
6934,2,True,4,4,8,1,1,pass
6936,1,False,11,2,13,1,1,fail
6937,1,False,63,31,94,6,1,fail
6938,2,True,192,18,210,3,1,fail
6940,1,False,56,648,704,10,1,pass
6941,2,True,5,4,9,1,1,pass
6942,1,True,6,3,9,1,1,fail
6943,1,False,1,0,1,1,1,pass
6944,1,True,17,21,38,2,1,pass
6945,1,True,192,86,278,2,1,fail
6946,1,False,6,0,6,1,1,pass
6948,1,True,5,4,9,1,1,pass
6950,1,True,5,2,7,1,1,pass
6952,1,False,3079,2811,5890,205,1,pass
6955,1,False,12,6,18,1,1,pass
6957,1,False,12,10,22,1,1,pass
6958,1,True,344,241,585,5,2,pass
6959,1,True,57,113,170,2,1,pass
6960,1,True,41,55,96,4,1,pass
6961,1,False,5,9,14,2,1,pass
6963,1,True,4,4,8,1,1,pass
6965,1,False,352,0,352,2,1,pass
6966,1,True,453,0,453,1,1,pass
6967,1,True,69,105,174,4,1,pass
6968,1,False,2,1,3,1,1,pass
6970,2,True,173,0,173,1,1,pass
6971,1,True,582,6,588,3,1,fail
6973,1,False,629,0,629,7,1,pass
6974,1,True,12,96,108,1,1,pass
6975,1,True,1,0,1,1,1,pass
6976,1,True,0,135,135,2,1,pass
6977,1,True,357,64,421,2,1,pass
6978,1,True,5,3,8,1,1,pass
6979,1,True,185,18,203,3,1,pass
6980,1,True,127,3,130,4,1,pass
6981,1,True,0,9434,9434,36,3,pass
6982,1,True,6,12,18,1,1,pass
6983,1,False,0,34,34,1,1,pass
6984,1,True,27,39,66,4,2,pass
6985,1,False,24,6,30,2,1,pass
6988,1,False,32,11,43,3,1,pass
6989,1,True,18,18,36,1,1,pass
6990,1,True,36,36,72,1,1,pass
6991,1,True,51,38,89,1,1,pass
6992,1,True,27,32,59,6,2,pass
6993,1,True,0,22,22,1,1,pass
6994,2,True,1,2,3,1,1,pass
6995,1,False,42,3,45,3,2,pass
6996,1,True,0,8,8,1,1,pass
6997,1,True,8,40,48,2,1,pass
6998,1,True,3,11,14,1,1,pass
6999,1,True,0,65,65,1,1,pass
7000,1,True,13,8,21,1,1,pass
7001,1,True,32,0,32,1,1,pass
7002,1,True,697,503,1200,2,1,pass
7004,2,True,2,0,2,1,1,pass
7005,1,False,9,1,10,1,1,pass
7007,2,True,42,8,50,2,1,pass
7008,1,True,0,331,331,1,1,pass
7009,1,True,331,0,331,1,1,pass
7010,1,True,0,331,331,1,1,pass
7011,1,True,2,2,4,1,1,fail
7012,1,True,6,4,10,1,1,fail
7014,1,False,27,13,40,1,1,pass
7015,1,False,1,1,2,1,1,pass
7017,1,True,40,8,48,2,1,fail
7018,1,False,689,14,703,16,2,pass
7020,1,False,10,11,21,2,1,fail
7021,1,True,1,1,2,1,1,pass
7022,1,True,1,1,2,1,1,pass
7023,1,True,2,0,2,1,1,pass
7024,1,True,331,0,331,1,1,pass
7025,2,True,289,79,368,7,1,pass
7027,1,False,9,3,12,1,1,pass
7028,1,True,2,3,5,1,1,pass
7029,2,True,3879,233588,237467,300,21,pass
7030,1,True,150,78,228,8,1,pass
7031,2,True,318,0,318,6,1,pass
7032,1,True,1,1,2,1,1,pass
7033,1,True,50,15,65,3,1,pass
7034,1,False,6,6,12,4,1,pass
7035,1,False,541,0,541,4,1,pass
7037,1,False,57,7,64,3,1,pass
7040,1,False,38,133,171,7,2,pass
7041,1,False,86,75,161,4,1,pass
7043,1,True,1,1,2,1,1,pass
7044,1,True,194,0,194,1,1,pass
7045,1,False,219,317,536,16,1,pass
7047,1,True,5,1,6,1,1,pass
7048,1,True,5,1,6,1,1,pass
7049,1,True,7,7,14,1,1,pass
7050,1,True,2,3,5,1,1,pass
7051,1,True,16,9,25,1,1,pass
7052,1,True,1,1,2,1,1,pass
7053,1,True,24,14,38,1,1,pass
7054,1,True,123,2,125,1,1,pass
7055,1,True,3,0,3,1,1,pass
7056,1,True,1,3,4,1,1,pass
7057,1,True,2,2,4,1,1,pass
7058,1,True,2,2,4,1,1,pass
7059,1,True,6,6,12,1,1,pass
7060,1,True,8,3,11,1,1,pass
7061,1,True,2,3,5,1,1,pass
7062,1,True,2,13,15,1,1,pass
7063,1,True,0,1,1,1,1,pass
7064,1,True,37,3,40,1,1,pass
7065,1,True,10,19,29,1,1,pass
7066,1,True,0,1,1,1,1,pass
7067,1,True,3,2,5,1,1,pass
7068,1,True,3,2,5,2,1,pass
7069,1,True,2,1,3,1,1,pass
7070,1,True,1,0,1,1,1,pass
7071,1,True,4,2,6,1,1,pass
7072,1,True,8,7,15,2,1,pass
7073,1,True,4,4,8,1,1,pass
7074,1,True,24,17,41,1,1,pass
7076,1,False,2,2,4,2,1,pass
7078,1,False,6,5,11,4,1,pass
7079,1,True,208,0,208,4,1,pass
7080,1,True,83,144,227,5,1,pass
7081,1,True,12,10,22,1,1,pass
7082,1,False,1,1,2,1,1,pass
7083,1,False,72,74,146,1,1,pass
7085,2,True,28,8,36,3,1,pass
7086,1,False,20,13,33,4,2,fail
7088,1,True,40,6,46,2,1,fail
7089,1,False,143,58,201,5,1,pass
7091,1,True,6,6,12,1,1,pass
7093,1,False,1,1,2,1,1,pass
7094,1,False,5,1,6,2,1,pass
7096,1,True,17,17,34,1,1,pass
7097,1,True,0,1,1,1,1,pass
7098,1,True,0,1,1,1,1,pass
7099,1,True,44,21,65,2,1,pass
7101,1,True,119,15,134,3,1,pass
7102,1,False,54,3,57,4,1,pass
7104,1,False,2,2,4,1,1,pass
7105,1,False,8,0,8,1,1,pass
7107,1,False,19,9,28,2,1,pass
7108,2,True,99,39,138,3,1,fail
7109,1,False,2,0,2,1,1,pass
7110,1,False,30,71,101,2,1,pass
7112,1,False,2,2,4,1,1,pass
7114,1,False,1,4,5,1,1,pass
7115,2,True,163,0,163,2,1,fail
7116,1,False,1554,0,1554,7,1,pass
7117,1,True,1,2,3,1,1,pass
7118,2,True,32679,253419,286098,300,10,pass
7119,2,True,2,2,4,1,1,fail
7120,2,True,69,47,116,3,1,fail
7122,2,True,28,0,28,2,1,pass
7123,1,True,0,23,23,1,1,fail
7124,2,True,1,0,1,1,1,fail
7125,1,False,17,5,22,1,1,pass
7126,1,True,0,34,34,1,1,fail
7127,1,True,85,0,85,2,1,fail
7128,1,True,54,0,54,1,1,pass
7130,1,False,1,1,2,1,1,pass
7131,1,True,1,0,1,1,1,pass
7132,2,True,8,8,16,2,1,pass
7134,1,True,1,2,3,1,1,pass
7136,1,False,0,8,8,8,1,pass
7137,1,True,14,231878,231892,300,24,pass
7139,1,False,115,66,181,9,1,pass
7141,1,False,40,79,119,17,1,pass
7142,1,True,1,2,3,2,1,pass
7143,1,True,29,23,52,8,1,pass
7144,1,True,21,38,59,2,1,pass
7145,2,True,201,20,221,3,1,pass
7147,1,True,51,46,97,1,1,pass
7148,1,True,113,3,116,3,1,pass
7150,1,False,1,0,1,1,1,pass
7151,1,True,13,10,23,1,1,pass
7152,1,True,2,2,4,1,1,fail
7153,1,True,177,7,184,6,1,pass
7154,1,True,73,3,76,2,1,fail
7155,1,True,2,2,4,1,1,pass
7156,1,False,7,3,10,2,1,pass
7157,1,True,56,5,61,1,1,fail
7159,1,False,19,4,23,2,1,pass
7161,1,False,1,0,1,1,1,pass
7162,1,False,0,6,6,1,1,pass
7164,1,False,2,36,38,1,1,pass
7165,1,True,1,1,2,1,1,fail
7166,1,True,2,2,4,1,1,pass
7167,1,True,10,1,11,2,1,fail
7168,1,True,64,15,79,2,1,pass
7170,1,False,1,0,1,1,1,pass
7171,1,False,120,191,311,10,1,pass
7173,1,False,16,46,62,5,1,fail
7174,1,True,3,3,6,1,1,pass
7175,1,True,41,1,42,2,1,pass
7176,1,False,23,315,338,10,3,pass
7179,1,False,2,2,4,1,1,pass
7181,1,False,65,6,71,2,1,pass
7183,1,False,3,4,7,3,1,pass
7184,1,True,2,0,2,1,1,pass
7186,1,False,1,1,2,1,1,pass
7187,1,True,15,11,26,2,1,pass
7189,1,False,2,2,4,1,1,pass
7190,1,False,0,1,1,1,1,pass
7191,1,True,20,21,41,2,1,fail
7192,1,True,1,1,2,1,1,pass
7193,1,True,2,0,2,1,1,pass
7194,1,True,4,4,8,1,1,pass
7195,1,True,4,4,8,1,1,pass
7196,1,True,7,6,13,1,1,pass
7197,1,True,1,2,3,1,1,pass
7199,1,False,145,28,173,5,1,fail
7201,1,False,2,1,3,1,1,fail
7203,2,True,5,5,10,1,1,fail
7205,1,False,3,29,32,2,1,fail
7207,1,False,11,5,16,3,1,pass
7208,1,False,1,1,2,1,1,fail
7210,1,True,1,1,2,2,1,pass
7211,1,True,0,1,1,1,1,pass
7212,1,True,134,11,145,1,1,pass
7213,2,True,63,48,111,2,1,pass
7214,1,True,7,16,23,4,1,pass
7215,1,True,153,12,165,4,1,pass
7216,1,True,7,2,9,1,1,fail
7217,1,True,62,52,114,1,1,pass
7218,1,True,2,2,4,1,1,pass
7219,1,True,6,1,7,1,1,pass
7221,1,False,63,48,111,2,1,pass
7222,1,True,48,8,56,3,1,pass
7223,2,True,786,118,904,28,2,pass
7224,1,False,18,0,18,2,1,pass
7225,1,True,61,5,66,2,1,pass
7226,1,True,79,8,87,2,1,pass
7227,1,True,33,138,171,1,1,pass
7228,1,False,2,2,4,1,1,pass
7230,1,False,50,19,69,1,1,pass
7232,1,False,17,13,30,1,1,pass
7233,1,True,4,4,8,1,1,fail
7234,1,False,60,26,86,6,1,pass
7235,1,False,8,8,16,5,1,pass
7237,1,True,16,3,19,2,1,pass
7238,1,False,12,0,12,1,1,pass
7241,1,False,13,0,13,1,1,pass
7242,1,True,118,13,131,2,2,pass
7243,1,True,0,2,2,1,1,pass
7244,1,True,18,28,46,4,1,pass
7245,1,True,0,12282,12282,34,1,pass
7246,1,True,24,6,30,3,1,pass
7247,1,True,9,19,28,2,1,pass
7248,1,False,49,13,62,1,1,pass
7250,1,True,12252,0,12252,33,1,pass
7251,1,True,65,63,128,5,1,pass
7252,2,True,20671,4705,25376,300,11,pass
7253,1,False,6,6,12,1,1,pass
7255,1,False,20,5,25,2,1,pass
7256,2,True,380,13,393,5,1,fail
7257,1,True,10,9,19,1,1,pass
7258,1,True,34,3,37,1,1,pass
7259,1,True,4,5,9,2,1,pass
7261,1,False,1,1,2,1,1,pass
7262,1,True,8,6,14,2,1,pass
7263,1,True,1,1,2,2,1,pass
7264,1,True,9,10,19,1,1,pass
7265,1,False,33,0,33,1,1,pass
7267,1,True,20,16,36,2,1,pass
7268,1,True,106,0,106,1,1,pass
7269,1,True,0,107,107,1,1,pass
7270,1,True,150,0,150,2,1,pass
7271,2,True,26508,6874,33382,300,12,pass
7272,1,False,49,0,49,1,1,pass
7274,1,True,2,0,2,1,1,pass
7276,1,False,4,1,5,1,1,pass
7277,1,True,0,2,2,1,1,pass
7278,2,True,2939,1543,4482,89,4,pass
7279,1,True,0,12252,12252,33,1,pass
7280,1,True,10,17,27,3,1,pass
7282,1,False,1,0,1,1,1,pass
7283,1,True,36,39,75,2,2,pass
7284,1,False,239,198,437,10,1,pass
7286,1,True,14,22,36,2,1,pass
7287,1,False,0,1,1,1,1,pass
7290,1,False,14,25,39,1,1,pass
7292,1,False,0,4,4,1,1,pass
7293,1,True,293,223,516,20,2,pass
7294,1,False,38,0,38,1,1,pass
7296,1,False,5,3,8,1,1,pass
7298,2,True,54,5,59,3,2,fail
7299,1,False,66,20,86,8,1,pass
7302,1,False,10,3,13,2,1,pass
7303,2,True,178,12,190,7,1,fail
7305,1,False,66,43,109,2,1,pass
7306,1,False,24,21,45,1,1,pass
7308,1,True,51,3,54,3,2,pass
7309,1,True,0,4,4,1,1,pass
7310,1,True,10,16,26,1,1,pass
7311,2,True,313,0,313,1,1,fail
7312,1,False,1,1,2,1,1,pass
7314,1,False,19,47,66,7,1,pass
7316,1,False,306,7,313,2,1,pass
7317,1,False,89,62,151,1,1,pass
7319,1,False,2,2,4,2,1,pass
7321,1,False,168,1,169,3,1,pass
7322,1,False,36,0,36,3,1,pass
7323,1,False,194,8,202,2,1,pass
7325,1,False,722,765,1487,7,1,pass
7326,1,False,16,7,23,3,1,pass
7327,1,False,24,0,24,2,1,pass
7328,1,False,16,17,33,4,2,pass
7329,1,True,15,0,15,1,1,pass
7330,1,True,12252,0,12252,33,1,pass
7331,1,True,2,2,4,1,1,pass
7332,1,True,4,4,8,1,1,pass
7334,1,False,3,2,5,1,1,pass
7335,1,True,6,6,12,1,1,pass
7336,1,True,12,0,12,1,1,pass
7337,1,True,1,27,28,1,1,pass
7338,1,True,30,0,30,2,1,pass
7339,1,True,3,2,5,2,1,pass
7340,1,True,3,3,6,1,1,pass
7341,1,True,52,27,79,1,1,pass
7342,1,True,0,2,2,1,1,pass
7343,1,True,0,3,3,1,1,pass
7344,1,False,2,0,2,1,1,pass
7346,1,True,2,0,2,1,1,pass
7347,1,False,69,95,164,1,1,pass
7349,1,True,5,5,10,3,1,pass
7350,1,True,42,57,99,1,1,pass
7351,1,True,0,6,6,1,1,pass
7352,1,True,8,6,14,2,1,pass
7353,1,True,16,0,16,1,1,pass
7354,1,True,0,12030,12030,35,2,pass
7355,1,True,8,8,16,4,1,pass
7356,1,True,36,265,301,3,1,pass
7357,2,True,397,42,439,26,3,pass
7358,1,True,0,293,293,1,1,pass
7359,1,True,319,0,319,1,1,pass
7360,2,True,1025,1554,2579,44,4,pass
7361,2,True,1,1,2,1,1,pass
7363,1,False,7,0,7,1,1,pass
7364,1,True,3,3,6,2,2,pass
7366,1,False,31,1,32,11,1,pass
7367,1,True,14,8,22,1,1,pass
7368,1,True,8,0,8,1,1,pass
7369,1,False,1,1,2,1,1,pass
7371,1,False,1,1,2,1,1,pass
7372,1,False,17,6,23,1,1,pass
7374,1,False,306,19,325,6,1,pass
7376,1,True,19,5,24,1,1,pass
7377,1,True,12,6,18,4,3,pass
7378,2,True,493,1381,1874,17,2,pass
7379,1,False,233,58,291,1,1,pass
7382,1,False,111,0,111,2,1,pass
7384,1,False,4,2,6,1,1,pass
7386,1,False,75,9,84,3,1,pass
7388,1,False,1,1,2,1,1,pass
7390,1,False,9,0,9,1,1,pass
7392,1,False,44,1304,1348,8,1,pass
7394,1,True,16,7,23,3,1,fail
7395,1,True,293,0,293,1,1,pass
7396,1,True,1,1,2,1,1,pass
7397,1,True,0,293,293,1,1,pass
7398,1,True,419,0,419,1,1,pass
7399,1,True,14346,0,14346,16,1,pass
7400,1,True,0,14926,14926,18,1,pass
7401,1,True,16,7,23,3,1,pass
7402,2,True,2,2,4,1,1,pass
7403,1,False,2,2,4,1,1,pass
7405,2,True,16955,2280,19235,249,10,pass
7406,1,True,12000,0,12000,34,2,pass
7407,1,True,2,1,3,1,1,pass
7408,1,False,3,6,9,1,1,pass
7410,1,True,133,122,255,5,3,pass
7411,1,False,14,9,23,1,1,pass
7413,2,True,15292,1679,16971,200,10,pass
7415,1,False,47,4,51,1,1,pass
7416,1,False,2,9,11,1,1,pass
7417,1,True,4,2,6,1,1,pass
7418,1,True,1,4,5,1,1,pass
7419,1,True,82,89,171,1,1,pass
7421,1,False,37,4,41,1,1,pass
7422,1,True,3,0,3,1,1,pass
7423,1,True,6823,812,7635,59,2,pass
7424,1,True,600,332,932,17,7,pass
7425,1,True,644,82,726,2,2,pass
7427,1,False,1,1,2,1,1,pass
7429,1,False,0,1,1,1,1,pass
7431,1,False,5,5,10,2,1,pass
7432,1,True,49,6,55,1,1,pass
7433,1,False,2,2,4,1,1,pass
7435,1,False,1,1,2,1,1,pass
7437,1,False,491,0,491,2,1,pass
7440,1,False,68,28,96,5,1,pass
7442,1,False,2025,0,2025,9,3,pass
7443,1,True,293,0,293,1,1,pass
7444,1,True,1,1,2,1,1,pass
7445,1,True,161,0,161,1,1,pass
7446,1,True,1,0,1,1,1,pass
7447,1,True,434,0,434,1,1,pass
7448,1,True,1280,68,1348,18,2,pass
7450,1,False,342,285,627,2,1,pass
7451,1,True,45,12,57,10,1,pass
7452,1,False,5,2,7,1,1,fail
7454,1,True,605,0,605,55,2,fail
7456,1,False,88,127,215,5,2,fail
7458,1,False,632,8,640,2,2,fail
7460,1,False,606,1,607,2,2,pass
7461,1,False,7,370,377,3,1,fail
7463,1,False,8,0,8,1,1,fail
7465,1,True,1258,255,1513,29,2,fail
7467,1,False,0,7,7,4,1,fail
7469,2,True,1,1,2,1,1,fail
7470,1,True,2,2,4,1,1,pass
7471,1,True,2,2,4,1,1,pass
7472,1,True,3,1,4,1,1,pass
7473,1,True,9,13,22,2,2,pass
7474,1,False,1,1,2,1,1,fail
7476,1,False,3,3,6,1,1,fail
7478,1,False,121,102,223,14,1,fail
7479,1,True,843,160,1003,11,2,fail
7481,1,False,20,19,39,1,1,fail
7483,1,False,30,6,36,7,1,fail
7484,1,True,244,33,277,10,1,fail
7485,1,False,3,1,4,1,1,fail
7488,1,False,104,41,145,4,1,fail
7489,1,False,2,2,4,1,1,fail
7491,1,True,91,120,211,4,2,fail
7492,1,False,3,0,3,1,1,fail
7494,1,True,17,27,44,1,1,pass
7496,1,False,4,4,8,1,1,fail
7497,1,True,496,0,496,2,2,pass
7498,1,True,1,1,2,1,1,fail
7500,1,False,115,76,191,11,1,fail
7501,1,True,1,1,2,1,1,fail
7502,1,True,0,133,133,1,1,pass
7503,1,True,0,0,0,1,1,pass
7504,1,True,0,1,1,1,1,pass
7505,2,True,7128,2168,9296,114,9,pass
7506,1,True,2,1,3,1,1,pass
7507,1,True,2,3819,3821,4,1,pass
7508,1,True,12,25,37,3,1,pass
7509,1,True,1,1,2,1,1,pass
7510,1,True,134,9,143,4,1,fail
7512,1,False,29,10,39,4,1,fail
7513,1,False,6,5,11,1,1,fail
7514,1,False,16,1,17,1,1,fail
7516,1,True,283,214,497,3,2,fail
7517,1,True,2876,54,2930,6,1,pass
7518,1,True,5,3,8,2,1,fail
7519,1,True,40,25,65,1,1,pass
7520,1,True,80,85,165,6,1,pass
7521,1,True,97,2,99,2,2,fail
7522,1,False,11,7,18,2,1,fail
7524,1,True,96,113,209,1,1,pass
7525,1,True,786,15,801,6,1,pass
7526,1,True,468,0,468,3,1,fail
7527,1,False,132,0,132,3,1,fail
7528,1,True,1,1,2,1,1,pass
7530,1,True,1374,351,1725,15,3,fail
7531,1,True,1,0,1,1,1,pass
7532,2,True,28651,18832,47483,300,10,fail
7533,1,True,1,1,2,1,1,pass
7534,1,True,2,1,3,1,1,pass
7535,1,False,23,7,30,3,1,fail
7537,1,True,4,2,6,1,1,fail
7538,1,True,2,2,4,1,1,fail
7539,1,True,506,130,636,12,2,fail
7540,1,True,1,1,2,1,1,fail
7541,1,True,104,98,202,2,1,pass
7543,1,False,888,2,890,7,2,fail
7545,1,False,3,4,7,1,1,fail
7548,1,False,8,7,15,1,1,fail
7549,1,True,6,5,11,1,1,pass
7550,1,True,1,1,2,1,1,fail
7551,1,True,144,165,309,3,1,pass
7552,1,True,0,2,2,1,1,pass
7553,1,True,4,4,8,1,1,pass
7554,1,False,30,3,33,2,1,fail
7556,1,True,0,673,673,2,1,pass
7557,1,True,673,0,673,2,1,pass
7558,1,True,0,666,666,2,1,pass
7559,1,True,35,33,68,2,1,pass
7560,1,True,36,36,72,4,1,pass
7561,1,False,9,8,17,1,1,fail
7563,1,True,39,22,61,3,1,pass
7565,1,False,391,6,397,2,1,fail
7566,1,True,38,2,40,2,1,pass
7567,1,True,1,30,31,1,1,pass
7568,1,True,2,2,4,1,1,pass
7569,1,True,0,8,8,1,1,pass
7570,1,True,0,5,5,1,1,pass
7571,1,True,1,0,1,1,1,pass
7572,1,True,3,3,6,1,1,pass
7573,1,True,14,14,28,2,1,pass
7574,1,True,14,13,27,1,1,fail
7575,1,True,25,0,25,1,1,fail
7576,1,True,4,6,10,2,1,fail
7577,1,True,2,1,3,1,1,fail
7578,1,False,202,31,233,3,1,fail
7580,1,True,5,3,8,2,1,fail
7581,1,True,6,6,12,1,1,fail
7582,1,True,0,1,1,1,1,fail
7583,1,True,32,0,32,1,1,fail
7584,1,True,3,2,5,1,1,fail
7585,1,True,0,22,22,1,1,fail
7586,1,True,51,0,51,1,1,fail
7587,1,True,41,19,60,1,1,fail
7588,1,True,17,3,20,1,1,fail
7589,1,True,2,0,2,1,1,fail
7590,1,True,4,2,6,1,1,fail
7591,1,True,35,2,37,2,1,fail
7593,1,False,4,80,84,3,1,fail
7594,1,True,8,2,10,2,1,fail
7595,1,True,21,21,42,3,1,pass
7596,1,True,711,21,732,4,1,pass
7597,1,True,16,17,33,2,2,fail
7598,1,True,699,36,735,16,4,fail
7599,1,True,967,1200,2167,34,4,fail
7601,1,False,30,237,267,6,2,fail
7603,1,False,107,28,135,4,2,fail
7604,2,True,59,2785,2844,20,2,pass
7606,1,False,9,6,15,1,1,fail
7607,1,True,4,3,7,2,1,pass
7609,1,False,2,2,4,1,1,pass
7611,2,True,3,3,6,1,1,pass
7612,1,False,4,870,874,6,2,pass
7615,1,False,0,1881,1881,10,2,pass
7617,1,False,41,23,64,1,1,fail
7619,1,False,2751,4,2755,16,2,fail
7620,1,True,399,122,521,18,4,pass
7621,1,False,2,0,2,1,1,pass
7622,1,False,25,25,50,9,1,pass
7624,1,False,6,6,12,1,1,pass
7626,1,False,57,19,76,2,1,pass
7628,1,False,1,1,2,1,1,pass
7630,1,False,12,0,12,2,1,pass
7631,1,False,268,7,275,4,1,pass
7632,1,False,136,4,140,2,1,pass
7633,1,True,1,1,2,1,1,pass
7634,1,False,10,3,13,1,1,pass
7635,1,False,0,11351,11351,70,5,pass
7636,1,False,398,25,423,8,1,pass
7637,1,True,3,3,6,1,1,fail
7638,1,False,16,12,28,1,1,pass
7639,1,True,7,0,7,1,1,pass
7640,1,True,31,32,63,1,1,pass
7641,1,True,8,8,16,1,1,pass
7642,1,False,95,37,132,5,2,pass
7643,1,False,15,0,15,1,1,pass
7644,1,False,9,9,18,1,1,pass
7645,1,False,71,71,142,1,1,pass
7646,1,True,26,3,29,1,1,pass
7647,1,False,102,10,112,3,1,pass
7648,1,False,480,6,486,3,1,pass
7649,1,False,3,3,6,1,1,pass
7650,1,False,50,0,50,2,1,pass
7651,1,True,11,16,27,1,1,pass
7652,1,True,3,2,5,1,1,pass
7653,1,False,1,0,1,1,1,pass
7654,1,False,224,192,416,9,2,pass
7655,1,True,4,4,8,1,1,pass
7656,1,True,37,14,51,1,1,pass
7657,1,True,2,1,3,1,1,pass
7658,1,True,8,0,8,1,1,pass
7659,1,True,13,0,13,1,1,pass
7660,1,True,66,0,66,1,1,pass
7661,1,True,0,0,0,1,1,pass
7662,1,False,24,7,31,1,1,pass
7663,1,False,80,33,113,1,1,pass
7664,1,False,1,0,1,1,1,pass
7665,1,False,161,41,202,2,1,pass
7667,1,True,2,15,17,1,1,pass
7668,1,True,11,103,114,1,1,pass
7669,1,True,24,1,25,1,1,pass
7670,1,False,8,6,14,1,1,pass
7671,1,False,1,1,2,1,1,pass
7672,1,True,142,2,144,1,1,pass
7673,1,True,2,2,4,1,1,pass
7674,1,False,6,9,15,2,1,pass
7675,1,False,1,0,1,1,1,pass
7676,1,False,412,59,471,9,1,pass
7677,1,False,0,1,1,1,1,pass
7678,1,True,114,52,166,1,1,pass
7679,1,False,41,63,104,4,1,pass
7680,1,False,22,3,25,2,2,pass
7681,2,True,21445,5004,26449,199,7,pass
7682,1,True,218,28,246,1,1,pass
7683,1,True,10,7,17,1,1,pass
7684,1,True,19143,3290,22433,162,7,pass
7685,1,False,11,6,17,1,1,pass
7687,1,False,3,3,6,1,1,pass
7688,1,False,1509,231,1740,1,1,pass
7689,1,False,32,17,49,2,1,pass
7690,1,False,44,35,79,2,1,pass
7691,1,False,16,0,16,1,1,pass
7692,1,False,5,3,8,1,1,pass
7693,1,False,329,451,780,12,2,pass
7694,1,True,0,1,1,1,1,pass
7695,1,True,256,922,1178,11,1,pass
7696,1,False,28,29,57,3,1,pass
7697,1,False,38,5,43,1,1,pass
7698,1,True,39,0,39,1,1,pass
7699,1,True,517,410,927,10,1,pass
7700,1,False,0,23,23,1,1,pass
7701,1,True,2,1,3,1,1,fail
7702,1,False,0,1,1,1,1,fail
7703,1,False,17,8,25,1,1,fail
7704,1,False,22,19,41,2,1,fail
7705,1,False,21,2,23,2,1,fail
7706,1,False,171,165,336,2,1,pass
7707,1,False,1,3,4,1,1,pass
7708,1,False,7,7,14,3,1,fail
7709,1,True,119,20,139,1,1,fail
7710,1,True,3,5,8,2,2,fail
7711,1,False,22,5,27,1,1,pass
7712,1,False,11,4,15,1,1,pass
7713,1,False,328,4,332,3,1,pass
7714,1,True,49,48,97,3,1,pass
7715,1,False,8,2,10,3,1,pass
7716,1,False,14,3,17,2,1,pass
7717,1,False,3,4,7,1,1,pass
7718,1,False,81,4,85,2,1,pass
7719,1,False,13,1,14,2,1,fail
7720,1,False,1,1,2,1,1,fail
7721,1,False,9,13,22,5,1,fail
7722,1,False,336,0,336,4,1,fail
7723,1,False,7,1,8,1,1,pass
7724,1,True,11,7,18,1,1,pass
7725,1,False,68,2,70,5,1,pass
7726,1,False,134,0,134,1,1,pass
7727,1,False,5,4,9,1,1,pass
7728,1,False,1,16,17,1,1,pass
7729,1,False,2,2,4,1,1,pass
7730,1,True,260,24,284,1,1,pass
7731,1,False,11,0,11,1,1,pass
7732,1,False,2,2,4,1,1,pass
7733,1,False,1,1,2,1,1,pass
7734,1,False,13,16,29,2,1,pass
7735,1,False,18,16,34,2,1,pass
7736,2,True,0,1,1,1,1,pass
7737,1,False,2,0,2,1,1,pass
7738,1,False,774,0,774,8,1,pass
7739,1,False,170,7,177,5,1,pass
7740,1,False,30,15,45,3,1,pass
7741,1,True,11,0,11,1,1,fail
7742,1,False,2,7,9,1,1,pass
7743,1,True,314,0,314,2,1,pass
7744,1,False,9,5,14,1,1,pass
7745,2,True,120,8,128,3,1,pass
7746,1,False,2,1,3,1,1,pass
7747,1,False,7,4,11,1,1,pass
7748,1,False,22,7,29,1,1,pass
7749,1,False,322,1,323,6,1,pass
7750,1,False,39,14,53,2,1,pass
7751,1,True,123,11,134,3,1,fail
7752,1,True,11,123,134,3,1,pass
7753,1,True,123,11,134,3,1,pass
7754,1,False,264,2600,2864,1,1,pass
7755,1,False,32,14,46,1,1,pass
7756,1,False,24,15,39,6,2,fail
7757,1,False,3,1,4,1,1,fail
7758,1,True,0,1,1,1,1,pass
7759,1,True,2,1,3,1,1,pass
7760,1,False,109,127,236,6,1,fail
7761,1,True,124,11,135,4,1,fail
7762,1,False,2,3,5,1,1,pass
7763,1,False,76,15,91,2,1,fail
7764,1,False,2,1,3,1,1,fail
7765,1,False,1,1,2,1,1,fail
7766,1,False,359,7,366,5,2,fail
7767,1,False,114,0,114,1,1,pass
7768,1,False,4,4,8,2,1,pass
7769,1,False,2,2,4,1,1,fail
7770,1,False,9,21,30,1,1,fail
7771,1,False,386,113,499,6,1,fail
7772,1,False,881,0,881,9,1,pass
7773,1,False,1,1,2,1,1,pass
7774,1,False,171,23,194,4,2,pass
7775,1,False,15,0,15,1,1,pass
7776,1,False,17,8,25,1,1,pass
7777,1,True,91,136,227,11,1,pass
7778,1,False,264,71,335,10,1,pass
7779,1,False,6,6,12,1,1,pass
7780,1,False,7,1,8,1,1,pass
7781,1,False,0,2,2,1,1,pass
7782,1,False,6,0,6,1,1,pass
7783,1,False,412,3,415,3,1,pass
7784,1,False,7,3,10,1,1,pass
7785,1,False,18,6,24,7,1,pass
7786,1,False,129,0,129,2,1,pass
7787,1,False,42,64,106,2,1,pass
7788,1,False,7,1,8,1,1,pass
7789,1,False,2,2,4,1,1,pass
7790,1,False,6,0,6,1,1,pass
7791,1,False,2,2,4,1,1,pass
7792,1,False,4,0,4,1,1,pass
7793,1,False,1,1,2,1,1,pass
7794,1,True,10483,5596,16079,300,6,fail
7795,1,False,1,1,2,1,1,fail
7796,1,False,2,0,2,1,1,fail
7797,1,False,1,0,1,1,1,fail
7798,1,False,5,0,5,1,1,fail
7799,1,False,12,3,15,4,1,fail
7800,1,False,2,2,4,1,1,fail
7801,2,True,1,1,2,1,1,fail
7802,1,False,1,0,1,1,1,fail
7803,1,False,7,38,45,3,1,fail
7804,1,True,1,2,3,1,1,fail
7805,1,False,1,1,2,1,1,fail
7806,1,False,21,4,25,1,1,fail
7807,1,False,97,71,168,2,1,fail
7808,1,False,0,24,24,1,1,fail
7809,1,False,0,1,1,1,1,fail
7810,1,True,18,0,18,3,1,pass
7811,1,False,8,3,11,1,1,pass
7812,1,True,220,43,263,4,3,pass
7813,1,False,3,2,5,1,1,pass
7814,1,False,2,1,3,1,1,pass
7815,1,False,11,9,20,2,1,pass
7816,2,True,1,1,2,1,1,pass
7817,1,True,1,1,2,1,1,pass
7818,1,True,868,102,970,12,4,pass
7819,1,False,60,24,84,6,1,pass
7820,1,False,3,1,4,1,1,pass
7821,1,False,2888,383,3271,2,1,pass
7822,1,False,324,366,690,5,1,pass
7823,1,False,1,1,2,1,1,pass
7824,1,False,1,0,1,1,1,pass
7825,1,False,1,0,1,1,1,pass
7826,1,True,1,0,1,1,1,pass
7827,1,True,1,1,2,1,1,fail
7828,1,False,0,117,117,1,1,pass
7829,1,True,2,2,4,1,1,fail
7830,1,False,3,3,6,1,1,fail
7831,1,False,13,13,26,6,2,fail
7832,1,False,8,8,16,1,1,fail
7833,1,False,275,49,324,2,1,fail
7834,1,False,24,364,388,30,1,fail
7835,1,False,4,1,5,1,1,pass
7836,2,True,2,2,4,1,1,pass
7837,1,False,15,5,20,2,1,pass
7838,1,False,2,2,4,2,1,pass
7839,1,False,1,1,2,1,1,fail
7840,1,False,29,3,32,1,1,fail
7841,1,False,2,0,2,1,1,fail
7842,1,False,9,6,15,3,1,fail
7843,1,False,23,7,30,1,1,fail
7844,1,True,2,2,4,1,1,pass
7845,1,True,1,1,2,1,1,fail
7846,1,False,0,11,11,1,1,fail
7847,1,True,24,29,53,6,1,fail
7848,1,False,159,7,166,5,1,pass
7849,1,False,0,7,7,5,1,pass
7850,1,False,40,2,42,2,1,pass
7851,2,True,1,0,1,1,1,pass
7852,1,False,8,3,11,1,1,pass
7853,2,True,1,0,1,1,1,pass
7854,1,True,1,0,1,1,1,pass
7855,1,False,10,1,11,1,1,pass
7856,1,True,1,0,1,1,1,pass
7857,1,False,9,5,14,2,1,pass
7858,1,False,14,9,23,2,1,pass
7859,1,False,3,0,3,1,1,pass
7860,1,False,16,13,29,1,1,pass
7861,1,False,6,0,6,3,1,pass
7862,1,False,5,8,13,1,1,pass
7863,1,False,483,0,483,8,2,pass
7864,1,False,4,99,103,6,1,pass
7865,1,False,0,125,125,1,1,pass
7866,1,False,125,0,125,1,1,pass
7867,1,False,2,1,3,1,1,pass
7868,1,False,5,1,6,1,1,pass
7869,1,True,2,2,4,1,1,pass
7870,1,False,6,16,22,6,1,pass
7871,1,False,1,1,2,1,1,pass
7872,1,True,15670,7109,22779,202,8,pass
7873,1,False,4,1,5,1,1,pass
7874,1,False,2,2,4,1,1,pass
7875,1,False,1,1,2,1,1,pass
7876,1,True,125,88,213,6,1,pass
7877,1,False,3,0,3,1,1,pass
7878,1,False,33,12,45,3,1,pass
7879,1,False,3,1,4,1,1,pass
7880,1,False,1,1,2,1,1,pass
7881,1,False,30,30,60,3,2,pass
7882,1,False,1,8,9,1,1,pass
7883,1,False,6,11,17,1,1,pass
7884,1,False,177,75,252,4,1,pass
7885,1,False,15,4,19,1,1,pass
7886,1,False,21,6,27,4,1,pass
7887,1,False,101,69,170,4,1,pass
7888,1,True,1,1,2,1,1,pass
7889,1,False,9,5,14,1,1,pass
7890,1,True,0,0,0,2,2,pass
7891,1,False,42,9,51,2,1,pass
7892,1,False,8,8,16,2,1,pass
7893,1,False,26,5,31,2,1,pass
7894,1,False,1,1,2,1,1,pass
7895,1,False,0,37,37,1,1,pass
7896,1,False,41,73,114,42,1,pass
7897,1,False,1,0,1,1,1,pass
7898,1,False,1,1,2,1,1,pass
7899,1,False,8,2,10,1,1,pass
7900,1,False,1,1,2,1,1,pass
7901,1,True,19,7,26,5,1,pass
7902,1,False,1,1,2,1,1,pass
7903,1,True,3,3,6,2,1,pass
7904,1,False,9,7,16,4,1,pass
7905,1,False,17,13,30,1,1,pass
7906,1,False,49,60,109,1,1,pass
7907,1,False,2,2,4,1,1,pass
7908,1,False,132,59,191,6,2,pass
7909,1,True,331,160,491,7,1,pass
7910,1,False,1,0,1,1,1,pass
7911,1,False,11,0,11,1,1,pass
7912,1,True,3,2,5,1,1,pass
7913,1,False,12,11,23,5,1,pass
7914,1,False,24,30,54,5,2,pass
7915,1,False,2,0,2,1,1,pass
7916,1,False,99,96,195,5,1,pass
7917,1,True,2752,438,3190,42,2,pass
7918,1,False,52,36,88,1,1,pass
7919,1,False,47,0,47,3,1,pass
7920,1,False,22,8,30,2,1,pass
7921,1,False,1,1,2,1,1,pass
7922,1,False,1,1,2,1,1,pass
7923,1,False,1,1,2,1,1,pass
7924,1,False,33,39,72,2,1,fail
7925,1,False,1,1,2,1,1,pass
7926,1,False,3,0,3,1,1,pass
7927,1,True,22,0,22,2,1,pass
7928,1,False,4,4,8,1,1,pass
7929,1,False,3,2,5,1,1,pass
7930,1,False,91,19,110,3,1,pass
7931,1,False,1,0,1,1,1,pass
7932,1,False,2,2,4,1,1,pass
7933,1,False,44,173,217,26,2,pass
7934,1,False,7,4,11,2,1,pass
7935,1,False,3,0,3,1,1,pass
7936,1,False,4,4,8,2,1,pass
7937,1,False,6,0,6,2,1,pass
7938,1,False,47,1,48,2,1,pass
7939,1,True,10,0,10,1,1,pass
7940,2,True,11,3,14,3,1,pass
7941,1,False,7,10,17,1,1,pass
7942,2,True,1,1,2,1,1,pass
7943,1,False,4,0,4,2,1,pass
7944,1,False,0,6,6,1,1,pass
7945,1,False,1,1,2,1,1,pass
7946,1,False,3,3,6,1,1,pass
7947,1,False,157,5,162,2,1,pass
7948,2,True,1,4,5,1,1,pass
7949,1,False,24,61,85,7,1,pass
7950,1,True,1,1,2,1,1,pass
7951,1,True,2,2,4,1,1,pass
7952,1,True,1,1,2,1,1,fail
7953,1,True,13,3,16,3,1,fail
7954,1,True,5,4,9,1,1,pass
7955,1,True,4,4,8,2,1,pass
7956,1,True,2,2,4,1,1,pass
7958,1,True,2,2,4,1,1,pass
7959,1,True,0,0,0,18,1,pass
7960,1,True,1,4,5,1,1,fail
7961,1,True,3,3,6,1,1,pass
7962,1,True,1,1,2,1,1,pass
7963,1,True,1,1,2,1,1,pass
7964,1,True,6,0,6,1,1,pass
7965,1,True,8,0,8,1,1,pass
7966,1,True,1,1,2,1,1,pass
7967,1,False,2,3,5,1,1,pass
7968,1,True,6,2,8,1,1,pass
7969,1,True,1,1,2,1,1,pass
7970,1,False,2,2,4,1,1,pass
7971,1,False,1,1,2,1,1,pass
7972,1,False,77,58,135,1,1,fail
7973,1,True,1,1,2,1,1,pass
7974,1,False,1,1,2,1,1,pass
7975,1,False,4,0,4,1,1,pass
7976,1,False,4,0,4,1,1,pass
7980,1,False,4,0,4,1,1,pass
7981,1,False,4,0,4,1,1,pass
7984,1,False,3,0,3,1,1,pass
7985,1,False,4,2,6,1,1,pass
7986,1,True,1,0,1,1,1,fail
7987,1,True,10,8,18,1,1,pass
7988,1,False,1,1,2,1,1,pass
7989,1,False,2,2,4,1,1,pass
7990,1,True,3,3,6,1,1,pass
7991,1,True,1,1,2,1,1,pass
7992,1,True,1,1,2,1,1,pass
7993,1,True,2,2,4,1,1,pass
7994,1,True,1,1,2,1,1,pass
7995,1,True,1,1,2,1,1,pass
7996,1,True,4,3,7,2,1,pass
7997,1,False,1,1,2,1,1,pass
7998,1,True,509,118,627,7,2,pass
7999,1,True,4,1,5,1,1,pass
8000,1,True,1,1,2,1,1,pass
8001,1,False,1,1,2,1,1,pass
8002,1,True,4,3,7,2,1,pass
8003,1,True,7,0,7,1,1,pass
8004,1,False,1,1,2,1,1,pass
8005,1,True,1,1,2,1,1,pass
8006,1,False,134,0,134,1,1,pass
8007,1,True,2,2,4,2,2,pass
8008,1,False,5,0,5,1,1,pass
8009,1,False,3,0,3,1,1,pass
8010,1,False,27,1,28,1,1,pass
8011,1,False,6,9,15,2,1,pass
8012,1,False,2,0,2,1,1,pass
8013,1,False,90,99,189,1,1,pass
8014,1,False,12,7,19,2,1,pass
8015,1,False,1,509,510,6,1,pass
8016,1,False,0,1,1,1,1,pass
8017,1,False,66,23,89,2,1,pass
8018,1,False,5,0,5,2,1,pass
8019,1,False,258,177,435,14,1,pass
8020,1,False,30,6,36,1,1,pass
8021,1,False,72,23,95,3,1,fail
8022,1,False,37,3,40,2,1,fail
8023,1,False,10,0,10,1,1,fail
8024,2,True,8488,2139,10627,222,9,pass
8025,1,False,6,3,9,3,1,fail
8026,1,False,63,21,84,3,2,fail
8027,1,False,25,22,47,4,1,pass
8028,1,False,7,1,8,1,1,pass
8029,1,False,14,10,24,1,1,pass
8030,1,False,72,1,73,2,1,pass
8031,1,False,21,10,31,2,1,pass
8032,1,False,377,2,379,5,1,pass
8033,1,False,1,2,3,2,1,pass
8034,1,False,2,2,4,1,1,pass
8035,1,False,7,2,9,1,1,pass
8036,1,True,30,2,32,1,1,pass
8037,1,False,5,9,14,3,2,pass
8038,1,False,5,6,11,1,1,pass
8039,1,False,3,0,3,1,1,pass
8040,1,False,3,0,3,1,1,pass
8041,1,False,4,0,4,4,1,pass
8042,1,False,1,5,6,4,1,pass
8043,1,True,1,1,2,1,1,pass
8044,1,False,291,0,291,5,1,pass
8045,1,False,353,1,354,3,1,pass
8046,1,False,18,9,27,1,1,pass
8047,1,True,0,0,0,0,0,pass
8048,1,False,2,14,16,6,1,pass
8049,1,False,5,0,5,1,1,pass
8050,1,False,87,22,109,2,1,pass
8051,1,False,6,0,6,1,1,pass
8052,1,False,4,1,5,1,1,pass
8053,1,False,4,0,4,1,1,pass
8054,1,False,293,393,686,17,1,pass
8055,1,False,14,13,27,2,1,pass
8056,1,False,57,26,83,1,1,pass
8057,1,False,1,7,8,1,1,pass
8058,1,False,5,5,10,2,1,pass
8059,1,False,3,2,5,1,1,pass
8060,1,False,13,4,17,1,1,pass
8061,1,False,8,5,13,2,1,pass
8062,1,False,34,17,51,2,1,pass
8063,1,False,57,32,89,2,1,pass
8064,1,False,24,11,35,11,1,pass
8065,1,False,4,2,6,1,1,pass
8066,1,False,3,25,28,3,2,pass
8067,1,False,13,342,355,5,1,pass
8068,1,False,72,43,115,3,1,pass
8069,1,False,1,1,2,1,1,pass
8070,1,True,2,2,4,1,1,pass
8071,2,True,14,0,14,1,1,pass
8072,1,False,3241,4,3245,25,5,pass
8073,1,False,14,18,32,2,1,pass
8074,1,True,153,2,155,40,1,pass
8075,1,False,30,6,36,2,1,pass
8076,1,False,2,1,3,1,1,pass
8077,1,False,1,1,2,1,1,pass
8078,1,True,14,0,14,1,1,pass
8079,1,False,12,25,37,1,1,pass
8080,1,False,13,5,18,5,1,pass
8081,1,False,0,1,1,1,1,pass
8082,1,False,1,1,2,1,1,pass
8083,1,False,150,126,276,4,1,pass
8084,1,False,0,1,1,1,1,pass
8085,1,False,13,0,13,1,1,pass
8086,2,True,2,0,2,1,1,pass
8087,1,False,1,0,1,1,1,pass
8088,1,False,6,8,14,7,1,pass
8089,1,False,3,0,3,2,1,pass
8090,1,False,36,33,69,3,1,pass
8091,1,False,2,1,3,1,1,pass
8092,1,True,2,0,2,1,1,pass
8093,1,False,0,4,4,2,1,pass
8094,1,False,381,36,417,12,2,pass
8095,1,False,2,5,7,1,1,pass
8096,1,False,39,14,53,2,1,pass
8097,1,False,16,14,30,2,1,pass
8098,1,True,1,1,2,1,1,pass
8099,1,False,1,1,2,1,1,pass
8100,1,False,8,10,18,9,1,pass
8101,1,False,1,1,2,1,1,pass
8102,1,False,25,10,35,3,1,pass
8103,1,False,9,8,17,3,1,pass
8104,1,True,34,31,65,2,2,pass
8105,1,False,2,2,4,4,2,pass
8106,1,False,2,124,126,1,1,pass
8107,1,False,13,3,16,1,1,pass
8108,1,True,3,0,3,1,1,pass
8109,1,False,17,10,27,2,1,pass
8110,1,False,27,3,30,2,1,pass
8111,1,False,2,1,3,1,1,pass
8112,1,False,124,13,137,3,1,pass
8113,1,False,10,4,14,1,1,pass
8114,2,True,16,10,26,1,1,pass
8115,1,False,4,0,4,1,1,pass
8116,1,False,2,0,2,1,1,pass
8117,1,False,300,115,415,1,1,pass
8118,1,False,90,3,93,2,1,pass
8119,1,True,94,4,98,3,2,pass
8120,1,False,32,3,35,7,1,pass
8121,1,True,16,10,26,1,1,pass
8122,1,True,1,1,2,1,1,pass
8123,1,False,3,2,5,1,1,pass
8124,1,False,6,11,17,4,1,pass
8125,1,False,21,19,40,1,1,fail
8126,1,False,692,59,751,9,1,fail
8127,1,False,27,16,43,2,1,pass
8128,1,True,0,6,6,3,2,pass
8129,2,True,7,12,19,2,1,pass
8130,1,False,0,109,109,1,1,pass
8131,1,True,2,2,4,1,1,pass
8132,1,True,17,17,34,2,2,pass
8133,1,True,2,7,9,1,1,fail
8134,1,True,5,5,10,1,1,pass
8135,1,False,3,19,22,3,2,pass
8136,1,False,38,12,50,2,1,pass
8137,1,False,104,106,210,1,1,pass
8138,1,False,27,24,51,1,1,pass
8139,1,False,15,18,33,1,1,pass
8140,1,False,26,30,56,7,3,pass
8141,1,False,18,27,45,15,1,pass
8142,1,True,78,82,160,1,1,pass
8143,1,False,16,2,18,1,1,pass
8144,1,False,65,51,116,4,1,pass
8145,1,False,2,0,2,1,1,pass
8146,1,False,2,3,5,1,1,pass
8147,1,False,384,0,384,2,2,pass
8148,1,False,1,3,4,1,1,pass
8149,1,False,34,11,45,5,1,pass
8150,2,True,5822,661,6483,85,4,pass
8151,1,False,278,26,304,4,1,pass
8152,1,False,1,1,2,1,1,pass
8153,1,False,0,33,33,1,1,pass
8154,1,False,5,8,13,6,1,fail
8155,1,False,1,161,162,6,1,pass
8156,1,False,61,86,147,2,1,pass
8157,1,False,13,2,15,3,2,fail
8158,1,False,2,1,3,1,1,fail
8159,1,False,5010,134,5144,27,3,fail
8160,1,False,58,126,184,2,1,pass
8161,1,False,11,11,22,6,1,pass
8162,1,False,22,1,23,2,1,pass
8163,1,False,11,10,21,2,1,pass
8164,1,False,280,57,337,6,1,pass
8165,1,False,60,7,67,2,1,pass
8166,1,False,2,0,2,1,1,pass
8167,2,True,120,110,230,25,1,pass
8168,2,True,1472,8044,9516,105,12,pass
8169,2,True,1472,8044,9516,105,12,fail
8170,2,True,118,54,172,2,1,pass
8171,2,True,17,9,26,1,1,pass
8172,1,False,133,21,154,2,1,pass
8173,1,False,6,6,12,1,1,pass
8174,1,True,2,2,4,1,1,fail
8175,1,True,1,2,3,1,1,pass
8176,1,False,0,1,1,1,1,pass
8177,1,False,427,79,506,6,1,pass
8178,1,False,2,5,7,1,1,pass
8179,1,False,306,36,342,4,1,pass
8180,1,False,1,1,2,1,1,pass
8181,1,True,0,2,2,1,1,pass
8182,1,True,0,7110,7110,49,11,pass
8183,1,False,21,36,57,4,1,pass
8184,1,False,7,1,8,1,1,pass
8185,1,True,90,69,159,26,1,pass
8186,1,False,8,1,9,2,2,pass
8187,1,False,1,1,2,1,1,pass
8188,1,False,11,23,34,1,1,pass
8189,2,True,2,2,4,2,1,pass
8190,1,False,24,24,48,14,1,pass
8191,1,False,27,8,35,2,2,pass
8192,1,False,3,5,8,2,1,pass
8193,1,False,17,497,514,16,1,pass
8194,1,False,1,1,2,1,1,pass
8195,1,False,0,1,1,1,1,pass
8196,2,True,1,1,2,1,1,pass
8197,1,True,2,2,4,2,1,pass
8198,1,True,3,3,6,3,1,pass
8199,1,True,1,1,2,1,1,pass
8200,1,False,1,1,2,1,1,pass
8201,1,False,2,2,4,1,1,pass
8202,1,False,16,5,21,1,1,pass
8203,1,False,3,4,7,1,1,pass
8204,1,False,18,2,20,1,1,pass
8205,1,False,0,3,3,1,1,pass
8206,1,False,296,2,298,1,1,pass
8207,1,False,0,106,106,1,1,pass
8208,1,False,10,5,15,1,1,pass
8209,1,False,0,2,2,1,1,pass
8210,1,False,6,0,6,1,1,pass
8211,2,True,207,160,367,65,2,pass
8212,1,False,9,11,20,10,1,pass
8213,1,False,11,34,45,34,1,pass
8214,1,False,3,3,6,1,1,pass
8215,1,False,1,36,37,6,1,pass
8216,1,False,39,6,45,6,1,pass
8217,1,False,14,10,24,1,1,pass
8218,1,False,10,10,20,1,1,pass
8219,1,False,4,4,8,5,1,pass
8220,1,False,4,0,4,1,1,pass
8221,1,True,2,0,2,1,1,fail
8222,1,True,33,16,49,1,1,pass
8223,1,False,0,2,2,1,1,pass
8224,1,False,3,1,4,1,1,pass
8225,1,False,18,8,26,2,1,pass
8226,1,False,58,9,67,2,1,pass
8227,1,False,10,6,16,1,1,pass
8228,1,False,9,7,16,1,1,pass
8229,1,False,2,3,5,1,1,pass
8230,1,False,0,2,2,1,1,pass
8231,1,False,17,14,31,6,2,pass
8232,1,False,9,9,18,9,1,pass
8233,1,False,1,2,3,1,1,pass
8234,1,False,1,0,1,1,1,pass
8235,1,False,2,1,3,1,1,pass
8236,2,True,229,264,493,31,2,pass
8237,1,False,4,31,35,4,1,pass
8238,1,False,0,8,8,2,1,pass
8239,1,False,11,9,20,3,1,pass
8240,1,True,0,2,2,1,1,pass
8241,1,False,51,4,55,5,1,pass
8242,1,False,16,192,208,11,1,pass
8243,1,False,14,10,24,1,1,pass
8244,1,False,133,8,141,6,1,pass
8245,2,True,309,92,401,18,3,pass
8246,1,False,200,24,224,5,1,pass
8247,1,False,9,9,18,1,1,pass
8248,1,False,13,5,18,1,1,pass
8249,1,False,26,10,36,8,1,pass
8250,1,False,0,35,35,2,2,pass
8251,1,False,61,9,70,1,1,pass
8252,2,True,422,6788,7210,80,5,pass
8253,1,False,1,1,2,1,1,pass
8254,1,False,0,2,2,1,1,pass
8255,1,False,33,33,66,16,1,pass
8256,1,False,68,0,68,1,1,pass
8257,1,True,0,6642,6642,27,3,pass
8258,1,True,320,110,430,35,3,pass
8259,1,False,1,0,1,1,1,pass
8260,1,False,6,3,9,1,1,pass
8261,1,False,17,20,37,1,1,pass
8262,1,False,45,14,59,7,1,pass
8263,1,False,1,0,1,1,1,pass
8264,1,False,5,2,7,1,1,pass
8265,1,False,0,4,4,1,1,pass
8266,1,False,334,0,334,2,1,pass
8267,1,False,57,41,98,1,1,pass
8268,1,True,1,0,1,1,1,pass
8269,1,True,14,0,14,1,1,pass
8270,1,False,5,7,12,1,1,pass
8271,1,True,1,1,2,1,1,pass
8276,1,True,1,1,2,1,1,pass
8277,1,False,1,0,1,1,1,pass
8278,1,False,471,11,482,2,1,fail
8279,1,False,55,1,56,1,1,pass
8280,1,False,8,0,8,1,1,pass
8281,1,True,7,3,10,1,1,pass
8282,1,False,18,0,18,1,1,pass
8283,1,False,16,120,136,5,1,pass
8284,1,False,0,4,4,1,1,pass
8285,1,False,53,10,63,2,1,fail
8286,1,False,7,5,12,1,1,fail
8287,1,False,51,0,51,1,1,fail
8288,1,False,1,0,1,1,1,fail
8289,1,False,14,5,19,1,1,fail
8290,1,False,1,1,2,1,1,fail
8291,1,False,2,2,4,1,1,fail
8292,1,False,1,1,2,1,1,pass
8293,1,False,106,11,117,4,1,fail
8294,1,False,8,8,16,3,1,pass
8295,1,False,8,1,9,1,1,pass
8296,2,True,1,6,7,1,1,pass
8297,1,True,1,6,7,1,1,pass
8298,2,True,736,599,1335,22,2,pass
8299,1,False,40,26,66,1,1,pass
8300,1,False,112,89,201,10,1,pass
8301,1,False,74,124,198,5,1,pass
8302,1,False,8,9,17,1,1,pass
8303,1,False,498,351,849,6,1,pass
8304,1,True,4,0,4,1,1,pass
8305,2,True,10,4,14,2,1,pass
8306,1,False,8,2,10,1,1,pass
8307,1,False,2,2,4,1,1,pass
8308,2,True,161,98,259,11,2,pass
8309,1,False,2,8,10,1,1,pass
8310,1,False,8,2,10,1,1,pass
8311,1,True,28,15,43,1,1,pass
8312,1,False,87,47,134,5,1,pass
8313,1,False,20,15,35,4,1,pass
8314,1,False,7,5,12,1,1,pass
8315,1,False,19,16,35,1,1,fail
8316,1,False,1,1,2,1,1,fail
8317,1,False,0,2,2,1,1,fail
8318,1,True,0,730768,730768,300,88,fail
8319,2,True,1,1,2,1,1,fail
8320,1,False,0,0,0,1,1,fail
8321,1,True,1,1,2,1,1,fail
8322,1,True,4,4,8,2,1,fail
8323,1,False,0,36,36,1,1,pass
8325,1,False,0,59,59,1,1,pass
8327,1,True,346,3,349,11,1,fail
8328,1,False,16,15,31,7,2,fail
8329,1,False,1,1,2,1,1,fail
8330,1,False,0,2,2,2,1,fail
8331,1,False,12,6,18,2,1,fail
8332,1,True,23,12,35,1,1,fail
8333,1,False,5,7,12,1,1,fail
8334,1,True,21,0,21,1,1,pass
8335,1,False,20,4,24,2,1,pass
8336,1,False,15,13,28,4,1,pass
8337,1,True,6,1,7,1,1,pass
8338,1,False,63,9,72,5,1,pass
8339,1,False,1,1,2,1,1,pass
8340,1,False,19,13,32,4,1,pass
8341,1,True,0,12,12,1,1,pass
8342,1,False,9,41,50,2,1,pass
8343,1,True,1,1,2,1,1,fail
8344,1,True,0,0,0,1,1,fail
8345,1,False,22,878,900,2,1,fail
8346,1,False,1241,302,1543,9,1,pass
8347,1,False,4,0,4,1,1,pass
8348,1,False,76,10,86,2,1,pass
8349,1,True,53,37,90,14,3,pass
8350,1,False,52,56,108,30,2,pass
8351,1,False,4,4,8,1,1,pass
8352,1,False,3,5,8,1,1,pass
8353,1,False,134,156,290,11,1,pass
8354,1,False,1,1,2,1,1,pass
8355,1,False,20,7,27,1,1,pass
8356,1,True,0,3367,3367,31,4,pass
8357,1,False,17,18,35,4,1,pass
8358,1,False,87,0,87,1,1,pass
8359,1,False,76,11,87,8,1,pass
8360,1,False,71,121,192,13,1,pass
8361,1,False,4,4,8,1,1,pass
8362,1,False,189,84,273,4,1,pass
8363,1,False,0,0,0,1,1,pass
8364,1,False,2,2,4,1,1,pass
8365,1,False,4,36,40,5,1,pass
8366,1,False,44,6,50,2,1,pass
8367,1,False,2,2,4,1,1,pass
8368,2,False,7,3,10,1,1,pass
8369,1,False,7,0,7,1,1,pass
8370,1,False,2,4,6,1,1,pass
8371,1,False,26,2,28,2,1,pass
8372,1,False,0,181,181,2,2,pass
8373,1,False,35,28,63,1,1,fail
8374,1,False,1,1,2,1,1,fail
8375,1,False,29,5,34,2,1,fail
8376,1,False,13,0,13,1,1,fail
8377,1,False,12,4,16,1,1,fail
8378,1,False,22,0,22,2,1,fail
8379,1,False,0,1,1,1,1,fail
8380,1,True,0,1,1,1,1,fail
8381,1,False,0,11936,11936,96,13,pass
8382,1,True,0,778,778,7,4,pass
8383,1,False,0,2,2,1,1,pass
8384,1,True,3,3,6,2,1,pass
8385,1,False,0,722,722,58,15,pass
8386,1,False,8,0,8,1,1,pass
8387,1,False,23,0,23,1,1,pass
8388,1,False,2,2,4,1,1,pass
8389,1,False,8,31,39,5,2,pass
8390,1,False,3,3,6,1,1,pass
8391,1,False,154,0,154,3,1,pass
8392,1,False,2,1,3,1,1,pass
8393,1,False,5,12,17,6,1,pass
8394,1,False,25,61,86,2,1,pass
8395,1,True,7,3,10,1,1,fail
8396,1,True,7,3,10,1,1,pass
8397,1,False,1,3,4,1,1,pass
8398,1,False,4,6,10,2,1,pass
8399,1,True,4,2,6,1,1,pass
8401,1,True,2,2,4,1,1,pass
8402,1,False,255,6,261,3,1,pass
8403,1,True,1,0,1,1,1,pass
8404,1,False,3,21,24,1,1,pass
8405,1,False,2,2,4,1,1,pass
8406,1,False,0,3,3,1,1,pass
8407,1,False,1,1,2,1,1,pass
8408,1,False,13,0,13,1,1,pass
8409,1,True,1436,1071,2507,58,3,pass
8410,1,False,0,37,37,5,1,pass
8411,1,False,1,0,1,1,1,pass
8412,2,False,2,0,2,1,1,pass
8413,1,True,2,0,2,1,1,pass
8414,1,False,0,2,2,1,1,pass
8415,1,False,17,0,17,1,1,pass
8416,1,True,31,35,66,7,2,pass
8417,1,False,0,1,1,1,1,pass
8418,1,False,6,0,6,1,1,pass
8419,1,False,6,6,12,1,1,pass
8420,1,False,29,7,36,2,1,pass
8421,1,False,13,8,21,1,1,pass
8422,1,False,83,60,143,5,1,pass
8423,1,False,222,49,271,4,1,pass
8424,1,True,1,1,2,1,1,pass
8425,1,True,12,2,14,1,1,pass
8426,1,True,5,3,8,2,2,pass
8427,1,True,2,2,4,1,1,pass
8428,1,False,7,4,11,1,1,pass
8429,1,False,36,1,37,4,1,pass
8430,1,False,2,0,2,2,1,pass
8431,1,False,82,9,91,2,1,pass
8432,1,True,118,89,207,9,1,pass
8433,1,False,6,8,14,1,1,pass
8434,1,False,8,8,16,2,1,pass
8435,1,False,1,1,2,1,1,pass
8436,1,False,2,1,3,1,1,pass
8437,1,False,226,147,373,10,1,pass
8438,1,False,34,27,61,7,1,pass
8439,1,False,4,4,8,1,1,pass
8440,2,False,3,0,3,1,1,pass
8441,1,True,1,1,2,1,1,pass
8442,1,False,5,5,10,4,1,pass
8443,2,False,2,2,4,1,1,pass
8444,1,False,1,4,5,1,1,pass
8445,1,True,1,0,1,1,1,fail
8446,1,False,43,32,75,2,1,pass
8447,1,True,2,2,4,1,1,pass
8448,1,True,1,1,2,1,1,pass
8449,1,False,953,35,988,4,1,pass
8450,1,False,32,23,55,3,1,pass
8451,2,False,1,1,2,1,1,fail
8452,1,False,961,12,973,6,1,fail
8453,1,True,1,0,1,1,1,pass
8454,1,False,1,1,2,1,1,pass
8455,1,False,46,10,56,2,1,pass
8456,1,False,7,7,14,1,1,fail
8457,1,False,13,49,62,15,1,pass
8458,1,False,17,1,18,1,1,fail
8459,1,True,2,0,2,1,1,fail
8461,1,True,1,1,2,1,1,pass
8468,1,False,9,7,16,1,1,fail
8469,1,False,95,1,96,2,1,fail
8470,1,False,0,0,0,1,1,fail
8471,1,False,0,0,0,1,1,fail
8472,1,False,12,37,49,4,1,fail
8473,1,False,26,19,45,6,1,fail
8474,1,False,20,14,34,1,1,fail
8475,1,False,2,19,21,2,1,pass
8476,1,False,9,54,63,1,1,pass
8477,1,True,1,1,2,1,1,pass
8478,1,False,35,0,35,1,1,pass
8479,1,False,51,62,113,8,1,pass
8480,1,False,62,51,113,8,1,fail
8481,2,False,2,1,3,1,1,pass
8482,1,False,110,0,110,1,1,pass
8483,1,True,2,1,3,1,1,pass
8484,1,False,31,8,39,1,1,pass
8485,1,False,7,2,9,1,1,pass
8486,1,False,20,1,21,2,1,pass
8487,1,False,2,2,4,1,1,pass
8488,1,False,14,1,15,2,1,pass
8489,1,False,12,3,15,1,1,pass
8490,1,False,86,0,86,1,1,pass
8491,1,False,33,18,51,1,1,pass
8492,1,False,20,4,24,3,1,pass
8493,1,False,131,1,132,1,1,pass
8494,1,False,1,1,2,1,1,pass
8495,1,False,1,1,2,1,1,pass
8496,1,True,34,11,45,2,1,pass
8497,1,False,4,0,4,1,1,pass
8498,1,False,176,4,180,4,1,pass
8499,1,False,0,9,9,1,1,pass
8500,1,False,4,5,9,1,1,pass
8501,1,False,44,197,241,4,1,pass
8502,1,False,321,1,322,4,1,fail
8503,1,False,197,44,241,4,1,fail
8504,1,False,0,15,15,2,1,pass
8505,1,False,368,0,368,2,1,pass
8506,1,False,50,38,88,4,1,pass
8507,1,False,36,31,67,3,1,pass
8508,1,False,26,24,50,5,1,pass
8509,1,False,597,0,597,2,1,fail
8510,1,False,55,109,164,2,1,pass
8511,1,True,3,3,6,1,1,pass
8512,1,False,29,0,29,2,1,pass
8513,1,False,3,1,4,1,1,pass
8514,1,False,4,2,6,2,1,pass
8515,1,False,8,11,19,1,1,pass
8516,1,False,35,5,40,1,1,pass
8517,1,False,109,177,286,3,1,pass
8518,1,False,8,37,45,3,1,pass
8519,2,False,1,1,2,1,1,pass
8520,1,True,1,1,2,1,1,pass
8521,1,True,1,1,2,1,1,pass
8522,1,False,4,3,7,1,1,pass
8523,1,False,35,109,144,2,1,pass
8524,1,False,1,19,20,2,1,pass
8525,1,False,12,4,16,2,1,pass
8526,1,False,17,21,38,1,1,pass
8527,1,False,19,1,20,2,1,pass
8528,1,False,50,377,427,4,1,pass
8529,1,False,1,0,1,1,1,pass
8530,1,False,72,77,149,8,1,pass
8531,1,False,43,6,49,2,1,pass
8532,1,False,150,3,153,3,1,pass
8533,1,False,30,1,31,9,1,pass
8534,1,False,0,7,7,2,1,pass
8535,1,False,55,38,93,6,1,pass
8536,1,True,0,0,0,0,0,pass
8537,1,False,32,0,32,1,1,pass
8538,1,False,64,211,275,4,1,pass
8539,1,False,41,13,54,6,1,pass
8540,1,True,22,1,23,1,1,pass
8541,1,False,0,4,4,1,1,pass
8542,1,False,1,1,2,1,1,pass
8543,1,False,3,3,6,2,1,pass
8544,1,False,4,2,6,1,1,pass
8545,1,False,16,16,32,5,1,pass
8546,1,False,83,0,83,1,1,pass
8547,1,True,3,0,3,1,1,pass
8548,1,True,2,2,4,1,1,pass
8549,1,True,18,10,28,1,1,pass
8550,1,True,1231,0,1231,8,4,pass
8551,1,False,34,12,46,1,1,pass
8552,1,False,16,39,55,2,1,pass
8553,1,False,16,16,32,1,1,fail
8554,1,True,12,12,24,1,1,pass
8555,1,False,8,8,16,1,1,pass
8556,1,False,17,6,23,2,1,pass
8557,1,False,2,4,6,1,1,pass
8558,1,False,33,47,80,5,2,pass
8559,1,False,2,0,2,1,1,fail
8560,1,True,1,1,2,1,1,pass
8561,1,False,125,91,216,6,1,pass
8562,1,False,5,3,8,1,1,pass
8563,1,False,104,75,179,3,1,pass
8564,1,False,10,10,20,7,1,pass
8565,1,False,1,1,2,1,1,pass
8566,1,False,19,2,21,2,2,pass
8567,1,False,1,3,4,1,1,pass
8568,1,False,0,41,41,2,1,fail
8569,1,False,22,21,43,1,1,pass
8570,1,True,1,1,2,1,1,pass
8571,1,False,9,4,13,1,1,pass
8572,1,True,4,4,8,1,1,pass
8573,1,False,2,1,3,1,1,pass
8574,1,False,48,41,89,3,1,pass
8575,1,True,1193,117,1310,67,4,fail
8576,1,False,21,23,44,6,1,fail
8577,1,True,5,8,13,2,2,fail
8578,1,True,986,785,1771,72,5,fail
8579,1,False,8,2,10,1,1,fail
8580,1,False,51,23,74,2,1,fail
8581,1,False,3,1,4,1,1,fail
8582,1,True,2,3,5,1,1,fail
8583,1,True,1,1,2,1,1,fail
8584,1,False,71,31,102,3,1,fail
8585,1,True,2951,589,3540,18,2,fail
8586,1,True,331,206,537,31,4,fail
8587,1,False,5,5,10,1,1,fail
8588,1,False,3,3,6,5,1,fail
8589,1,False,478,3,481,2,2,fail
8590,1,False,2,2,4,2,1,fail
8591,1,False,4240,31,4271,36,2,fail
8592,1,False,5,5,10,1,1,pass
8593,1,False,1,1,2,1,1,pass
8594,1,False,22,1,23,2,1,fail
8595,1,True,3,2,5,1,1,pass
8596,1,False,0,7,7,1,1,pass
8597,1,False,3,0,3,1,1,pass
8598,1,False,136,82,218,4,1,pass
8599,1,False,48,89,137,1,1,pass
8600,1,False,17,3,20,4,1,pass
8601,1,False,0,40,40,1,1,pass
8602,1,False,12,3,15,2,1,fail
8603,1,False,14,2,16,1,1,fail
8604,1,False,1,1,2,1,1,fail
8607,1,False,45,6,51,1,1,pass
8608,1,False,2,2,4,1,1,pass
8609,1,False,22,17,39,2,1,pass
8610,1,False,27,3,30,2,1,fail
8611,1,False,89,6,95,2,1,fail
8612,1,False,1,0,1,1,1,fail
8613,1,False,26,25,51,4,1,fail
8614,1,False,5,6,11,1,1,fail
8615,1,False,258,0,258,2,1,fail
8616,1,False,100,79,179,6,2,pass
8617,1,False,45,63,108,2,1,pass
8618,1,False,856,0,856,2,1,pass
8619,1,False,2,2,4,1,1,pass
8620,1,False,37,0,37,1,1,pass
8621,1,False,55,6,61,4,1,pass
8622,1,False,4,3,7,1,1,pass
8623,1,False,42,0,42,1,1,pass
8624,1,False,55,0,55,1,1,pass
8625,1,False,55,2,57,2,1,pass
8626,1,False,1,1,2,1,1,pass
8627,1,False,0,4,4,1,1,pass
8628,1,False,64,14,78,5,1,pass
8629,2,False,1,1,2,1,1,pass
8630,1,False,8,8,16,2,1,pass
8631,1,False,1204,1,1205,5,1,pass
8632,1,False,17,31,48,3,1,pass
8633,1,False,160,98,258,5,1,pass
8634,1,True,1,1,2,1,1,pass
8635,1,False,5,11,16,4,1,pass
8636,1,True,3,0,3,1,1,pass
8637,1,False,235,25,260,2,1,pass
8638,1,False,567,29,596,5,1,pass
8639,1,False,25,12,37,3,1,pass
8640,2,False,2,5,7,1,1,fail
8641,1,False,0,1,1,1,1,pass
8642,1,False,0,9,9,1,1,pass
8643,1,True,1,5,6,1,1,fail
8644,1,False,44,23,67,4,1,pass
8645,1,False,4,3,7,3,1,pass
8646,1,False,0,1,1,1,1,pass
8647,1,False,9,8,17,2,1,pass
8648,1,False,6,6,12,3,1,pass
8649,1,False,4,2,6,2,1,pass
8650,2,False,1,1,2,1,1,pass
8651,1,True,1,1,2,1,1,pass
8652,1,True,117,33,150,11,1,pass
8653,1,False,23,0,23,2,1,pass
8654,1,False,49,23,72,5,1,pass
8655,1,False,20,4,24,1,1,pass
8656,1,False,23,21,44,3,1,pass
8657,1,False,9,1,10,1,1,pass
8658,1,False,1,1,2,1,1,pass
8659,1,False,214,163,377,2,1,pass
8660,1,False,15,39,54,6,1,pass
8661,1,False,6,5,11,1,1,pass
8662,1,False,23,294,317,9,2,pass
8663,1,False,359,126,485,2,1,pass
8664,1,False,1,1,2,1,1,pass
8666,1,True,4651,752,5403,92,8,pass
8667,1,True,2,1,3,1,1,fail
8668,2,False,1,1727,1728,12,2,pass
8669,1,True,1,1,2,1,1,fail
8670,1,False,1726,0,1726,11,1,fail
8671,1,False,0,0,0,1,1,pass
8672,1,False,2,1,3,1,1,pass
8673,1,True,1,2,3,1,1,pass
8674,1,True,20,18,38,3,1,fail
8675,1,False,11,4,15,1,1,pass
8676,1,False,6,4,10,1,1,pass
8677,1,False,34,12,46,3,1,pass
8678,1,False,88,19,107,6,1,pass
8679,1,False,11,4,15,1,1,pass
8680,1,False,9,8,17,2,1,pass
8681,1,False,7,2,9,1,1,pass
8682,1,False,25,2,27,5,1,pass
8683,1,False,18,3,21,2,1,pass
8684,1,False,115,91,206,2,1,pass
8685,1,False,53,212,265,1,1,pass
8686,1,False,6,0,6,1,1,pass
8687,1,False,32,1,33,1,1,pass
8688,1,False,9,5,14,1,1,pass
8689,1,False,2,1,3,1,1,pass
8690,1,False,8,6,14,1,1,pass
8691,2,False,9,8,17,4,1,pass
8692,1,True,9,8,17,4,1,fail
8693,1,True,8,9,17,4,1,pass
8694,1,True,20,22,42,9,1,pass
8695,1,False,7,1,8,2,2,pass
8696,1,False,98,39,137,7,1,pass
8697,1,False,24,1,25,1,1,pass
8698,1,True,1,1,2,1,1,pass
8699,1,True,1,1,2,1,1,pass
8700,1,False,33,19,52,4,1,pass
8701,1,False,1,1,2,1,1,pass
8702,1,False,4,4,8,4,1,pass
8703,1,False,237,4,241,3,1,pass
8704,1,False,1,0,1,1,1,pass
8705,1,False,0,0,0,1,1,pass
8706,1,False,1,0,1,1,1,pass
8707,1,False,11612,0,11612,55,2,pass
8708,1,True,1,1,2,1,1,pass
8709,1,False,6,4,10,2,1,fail
8710,1,False,0,1,1,1,1,pass
8711,1,False,7,15,22,1,1,pass
8712,1,True,130,8,138,8,2,pass
8713,1,False,1,1,2,1,1,pass
8714,1,False,87,17,104,2,1,pass
8715,1,False,6,3,9,1,1,pass
8716,1,False,2,2,4,1,1,pass
8717,1,False,7,10,17,1,1,pass
8718,1,False,213,4,217,8,1,pass
8719,1,False,2,1,3,1,1,pass
8720,1,False,1,1,2,1,1,pass
8721,1,False,7,6,13,1,1,pass
8722,1,False,2,2,4,1,1,pass
8723,1,False,164,98,262,3,1,pass
8724,1,False,145,150,295,5,1,pass
8725,2,False,8,6,14,1,1,pass
8726,1,False,177,10,187,4,1,pass
8727,1,True,8,6,14,1,1,fail
8728,1,True,9,768,777,4,4,pass
8729,1,False,61,0,61,1,1,pass
8730,1,False,3,2,5,1,1,pass
8731,1,False,2,9,11,1,1,pass
8732,1,False,4,4,8,2,1,pass
8733,1,False,190,41,231,6,1,fail
8734,1,False,1,0,1,1,1,pass
8735,1,False,33,3,36,2,1,fail
8736,1,False,3,2,5,1,1,pass
8737,1,False,2,2,4,1,1,pass
8738,1,False,2,2,4,1,1,pass
8739,1,True,0,6234,6234,30,3,pass
8740,1,False,345,403,748,11,1,pass
8741,1,False,175,20,195,8,1,pass
8742,2,False,1,1,2,1,1,pass
8743,1,False,214,3,217,4,1,pass
8744,2,True,1,1,2,1,1,pass
8745,1,True,1,1,2,1,1,pass
8746,1,False,12,1,13,1,1,pass
8747,1,True,1,1,2,1,1,pass
8748,1,False,0,211,211,1,1,pass
8749,1,False,211,0,211,1,1,fail
8750,2,False,1,1,2,1,1,pass
8751,1,False,31,56,87,5,1,pass
8752,1,True,1,1,2,1,1,fail
8753,1,False,1,2,3,1,1,fail
8754,1,False,5,10,15,1,1,pass
8755,1,False,11,7,18,2,1,pass
8756,1,False,2,2,4,1,1,pass
8757,1,False,5,3,8,2,1,pass
8758,2,False,14,6,20,1,1,pass
8759,1,False,8,9,17,5,1,pass
8760,1,True,14,6,20,1,1,fail
8761,1,False,1,1,2,1,1,pass
8762,1,False,13,13,26,15,1,pass
8763,1,False,35,35,70,1,1,pass
8764,1,False,7,9,16,2,2,pass
8765,2,False,5,5,10,1,1,pass
8766,1,False,280,237,517,26,2,pass
8767,1,True,5,5,10,1,1,fail
8768,2,False,38,3,41,1,1,pass
8769,1,False,5,0,5,1,1,pass
8770,1,False,8,7,15,4,1,pass
8771,1,False,2,0,2,1,1,fail
8772,1,False,85,2,87,1,1,fail
8773,2,False,1,0,1,1,1,pass
8774,1,False,6427,0,6427,19,2,pass
8775,1,True,1,0,1,1,1,fail
8776,1,False,1,1,2,1,1,fail
8777,1,True,38,3,41,1,1,fail
8778,1,False,8,7,15,1,1,fail
8779,1,False,35,31,66,13,1,fail
8780,1,False,1,0,1,1,1,fail
8781,2,False,83,1,84,2,1,pass
8782,1,True,1,1,2,1,1,fail
8783,1,True,8,17,25,2,1,fail
8784,2,False,101,1,102,6,1,pass
8785,1,False,1,1,2,1,1,pass
8786,1,False,5,8,13,2,2,pass
8787,1,False,2,3,5,1,1,pass
8788,1,False,4,1,5,1,1,pass
8789,1,False,86,97,183,4,1,pass
8790,1,True,72,0,72,2,1,fail
8791,1,True,8,0,8,1,1,fail
8792,1,True,8,0,8,1,1,fail
8793,1,True,92,1,93,2,1,fail
8794,1,False,25,12,37,5,1,pass
8795,1,False,35,29,64,13,1,pass
8796,1,False,8,2,10,2,1,pass
8797,1,False,2,2,4,1,1,pass
8798,1,False,60,129,189,4,1,pass
8799,1,True,10,1,11,2,1,fail
8800,1,False,2,7,9,2,1,pass
8801,1,False,6,5,11,4,1,pass
8802,1,False,20,16,36,3,1,pass
8803,1,False,70,57,127,5,1,pass
8804,1,False,0,5,5,1,1,pass
8806,1,False,41,27,68,5,1,fail
8807,1,False,1,0,1,1,1,pass
8808,1,False,4,0,4,1,1,pass
8809,1,False,1,1,2,1,1,pass
8810,1,False,3,0,3,1,1,pass
8811,2,False,119,5,124,7,1,pass
8812,1,False,3,2,5,1,1,pass
8813,1,False,5,1,6,1,1,pass
8814,1,False,4,4,8,2,1,pass
8815,2,True,1258,447,1705,55,4,pass
8816,1,True,115,101,216,9,6,pass
8817,1,False,2,1,3,1,1,pass
8818,1,False,38,8,46,3,1,pass
8819,1,False,3,3,6,1,1,pass
8820,1,False,3,0,3,1,1,pass
8821,1,False,237,0,237,2,1,pass
8822,2,False,127,135,262,15,6,pass
8823,1,False,14,4,18,5,1,pass
8824,1,False,7,1,8,1,1,pass
8825,2,False,33,1,34,3,1,pass
8826,1,False,6,2,8,1,1,pass
8827,1,False,7,6,13,4,1,pass
8828,2,True,1850,1612,3462,93,8,fail
8829,2,True,1850,1639,3489,93,8,pass
8830,1,False,77,53,130,1,1,pass
8831,1,False,8,3,11,4,1,pass
8832,1,False,8,22,30,1,1,pass
8833,1,True,115,101,216,9,6,pass
8834,1,False,1,0,1,1,1,pass
8835,1,False,5,3,8,2,1,pass
8836,1,False,2,1,3,1,1,pass
8837,1,False,16,55,71,7,1,pass
8838,1,False,1,1,2,1,1,pass
8839,1,False,415,135,550,7,1,pass
8840,1,False,5,0,5,1,1,pass
8841,1,False,1,1,2,1,1,fail
8842,1,False,270,106,376,3,1,pass
8843,1,True,2,2,4,2,1,fail
8844,1,False,1,1,2,1,1,pass
8845,1,False,16,1,17,1,1,pass
8846,1,False,20,5,25,2,1,pass
8847,1,False,8,0,8,1,1,pass
8848,1,False,0,0,0,1,1,pass
8849,1,False,2,2,4,1,1,pass
8850,1,False,9,20,29,3,1,pass
8851,1,False,14,14,28,1,1,pass
8852,2,False,119,125,244,12,6,pass
8853,1,True,34,11,45,4,1,fail
8854,1,True,1,1,2,1,1,fail
8855,1,True,5,1,6,1,1,fail
8856,1,True,3,4,7,1,1,fail
8857,1,True,13,13,26,1,1,fail
8858,1,False,4,4,8,5,1,pass
8859,1,True,18,19,37,3,1,fail
8860,2,True,10,1,11,2,1,fail
8861,2,True,2065,1425,3490,86,8,fail
8862,1,False,29,28,57,9,1,pass
8863,1,False,145,110,255,18,2,pass
8864,1,False,1,2,3,1,1,pass
8865,1,True,0,7,7,1,1,pass
8866,1,True,115,95,210,8,5,pass
8867,1,False,8,0,8,1,1,pass
8868,1,True,2,2,4,1,1,pass
8869,1,True,1,1,2,1,1,pass
8870,1,True,14,7,21,1,1,pass
8871,1,False,8,8,16,10,3,pass
8872,1,False,6,1,7,1,1,pass
8873,1,False,12,11,23,1,1,pass
8874,1,False,1,1,2,1,1,pass
8875,1,False,0,506,506,5,2,fail
8876,1,False,1,1,2,6,3,fail
8877,1,False,3,9,12,2,1,pass
8878,1,False,52,58,110,3,1,fail
8879,2,False,3,0,3,2,1,pass
8880,1,False,47,13,60,1,1,pass
8881,1,True,3,0,3,2,1,pass
8882,1,False,4,0,4,1,1,fail
8883,1,False,155,11,166,6,1,pass
8884,1,True,1,1,2,1,1,pass
8885,1,False,2,2,4,1,1,pass
8886,1,False,2,1,3,1,1,fail
8887,1,False,236,45,281,5,1,fail
8888,1,False,15,5,20,1,1,fail
8889,1,False,3,6,9,1,1,fail
8890,1,False,46,7,53,3,1,fail
8891,2,False,1,16,17,2,2,fail
8892,1,False,5,34,39,3,1,pass
8893,1,True,1,1,2,1,1,fail
8894,2,True,0,43,43,1,1,fail
8895,1,True,34,5,39,3,1,pass
8896,1,True,14,3,17,2,1,pass
8897,1,True,25,0,25,1,1,pass
8898,2,False,0,218,218,1,1,pass
8899,1,False,1,1,2,1,1,fail
8900,1,False,1,1,2,1,1,fail
8901,1,True,0,15,15,1,1,pass
8902,1,True,4,0,4,1,1,fail
8904,1,False,27,0,27,1,1,pass
8905,1,True,0,218,218,1,1,pass
8906,2,True,0,43,43,1,1,fail
8907,1,True,0,27,27,1,1,fail
8908,2,True,1289,402,1691,25,3,fail
8909,2,True,1282,395,1677,25,3,pass
8910,1,True,7,7,14,1,1,fail
8911,1,True,870,66,936,10,3,fail
8912,1,True,374,319,693,10,1,fail
8913,1,True,31,3,34,6,1,pass
8914,1,True,67,1,68,1,1,fail
8915,1,True,0,3,3,1,1,fail
8916,1,True,0,3,3,1,1,pass
8917,2,True,110,33,143,7,1,pass
8918,2,True,110,33,143,7,1,pass
8919,1,True,16,0,16,1,1,pass
8920,1,True,21,1,22,3,1,pass
8921,1,True,20,3,23,2,1,fail
8922,1,True,10,1,11,2,1,fail
8923,1,True,9,1,10,2,1,fail
8924,1,True,90,30,120,5,1,fail
8925,1,True,3,0,3,1,1,pass
8926,1,True,4,0,4,1,1,pass
8927,1,True,15,6,21,4,1,fail
8928,1,True,2,0,2,1,1,fail
8929,1,True,1,69,70,3,1,fail
8930,1,True,2,2,4,1,1,fail
8931,1,True,1,0,1,1,1,fail
8932,1,True,725,7,732,3,1,fail
8933,1,True,65,6,71,2,1,fail
8934,1,True,3,1,4,1,1,fail
8935,1,True,89,144,233,7,1,fail
8936,1,True,3,5,8,1,1,fail
8937,1,True,44,0,44,1,1,fail
8938,1,True,7,160,167,5,1,fail
8939,1,True,3,6,9,1,1,fail
8940,1,True,33,7,40,1,1,fail
8941,1,True,33,58,91,4,1,fail
8942,1,True,1,1,2,1,1,fail
8943,1,True,0,27,27,1,1,fail
8944,1,True,751,70,821,8,1,fail
8945,1,True,47,10,57,5,5,fail
8946,1,True,20,24,44,5,1,fail
8947,1,True,210,167,377,14,2,fail
8948,1,True,11,17,28,5,1,fail
8949,1,True,4,4,8,2,1,fail
8950,1,True,46,23,69,2,1,fail
8951,1,True,2,2,4,2,1,fail
8952,1,True,25,22,47,4,1,fail
8953,1,True,20,0,20,1,1,fail
8954,1,True,29,0,29,1,1,pass
8955,1,True,1,1,2,1,1,pass
8956,1,True,10,4,14,3,1,fail
8957,1,True,4,1,5,1,1,fail
8959,1,True,1,0,1,1,1,fail
8960,1,True,2,2,4,1,1,pass
8961,1,True,3,2,5,1,1,fail
8962,1,True,300,110,410,6,1,pass
8963,1,True,137,10,147,6,1,fail
8964,1,True,1,1,2,1,1,fail
8965,1,True,11,0,11,1,1,fail
8966,1,True,146,29,175,4,1,fail
8967,1,True,32,21,53,1,1,fail
8968,1,True,1,1,2,1,1,pass
8969,1,True,29,2,31,1,1,pass
8970,1,True,1,1,2,1,1,fail
8971,1,True,3,3,6,1,1,fail
8972,1,True,6,6,12,1,1,fail
8973,1,True,42,35,77,1,1,pass
8974,1,True,2,5,7,1,1,pass
8979,1,True,3,2,5,2,2,pass
8980,1,True,229,29,258,12,1,fail
8981,1,True,10,2,12,2,1,fail
8982,1,True,231,86,317,5,1,fail
8983,1,True,15,1,16,1,1,pass
8984,1,True,68,26,94,4,1,pass
8985,1,True,183,2,185,3,2,fail
8986,1,True,62,0,62,1,1,fail
8987,1,True,4,19,23,1,1,fail
8988,1,True,3,4,7,1,1,fail
8990,1,True,3,126,129,2,1,fail
8991,1,True,33,29,62,8,1,fail
8992,1,True,4,2,6,1,1,fail
8993,1,True,1,1,2,1,1,fail
8996,1,True,2,0,2,1,1,pass
8997,1,True,2,4,6,1,1,pass
8998,1,True,5,4,9,2,2,pass
8999,1,True,17,17,34,2,1,fail
9000,1,True,2,2,4,1,1,fail
9001,1,True,404,26,430,3,1,pass
9002,1,True,3,0,3,1,1,fail
9003,1,True,1,1,2,1,1,pass
9005,1,True,21,10,31,2,1,pass
9006,1,False,18,3,21,1,1,fail
9007,1,True,9,3,12,1,1,pass
9008,1,True,3154,6,3160,28,11,fail
9009,1,True,247,0,247,2,2,fail
9010,1,True,45,12,57,1,1,fail
9011,1,True,7014,1027,8041,148,4,pass
9012,1,True,1,1,2,1,1,fail
9013,1,True,24,9,33,2,1,pass
9014,1,True,29,28,57,2,1,fail
9015,1,True,177,1,178,2,1,fail
9016,1,True,15,21,36,2,1,pass
9017,1,True,15,1,16,1,1,fail
9018,1,True,88,107,195,2,1,fail
9019,1,True,12,10,22,1,1,fail
9020,1,True,61,54,115,1,1,fail
9021,1,True,32,5,37,2,1,fail
9022,1,True,1,2,3,1,1,fail
9023,1,True,1,1,2,1,1,fail
9024,1,True,1,1,2,1,1,fail
9025,1,True,233,124,357,29,2,fail
9026,1,True,59,57,116,5,1,fail
9027,1,True,7,0,7,1,1,fail
9028,1,True,2,2,4,1,1,fail
9029,1,True,54,2,56,1,1,fail
9030,1,True,5,4,9,2,1,fail
9031,1,True,3,1,4,1,1,fail
9032,1,True,281,6,287,3,2,fail
9033,1,True,1,1,2,1,1,fail
9034,1,True,14,4,18,2,1,fail
9035,1,True,45,23,68,2,1,fail
9036,1,True,17,0,17,1,1,pass
9037,1,True,6,8,14,3,2,fail
9038,1,True,62,47,109,4,2,fail
9039,1,True,6,1,7,3,1,fail
9040,1,True,12,4,16,1,1,fail
9041,1,True,118,27,145,1,1,fail
9042,1,True,129,71,200,13,1,fail
9043,1,True,9,11,20,2,1,fail
9044,1,True,1,2,3,1,1,fail
9045,1,True,11,9,20,2,1,fail
9046,1,True,1,1,2,1,1,fail
9047,1,True,3,3,6,1,1,fail
9048,1,True,65,2,67,5,1,fail
9049,1,True,22,10,32,1,1,fail
9050,1,True,140,0,140,1,1,fail
9051,1,True,2,2,4,2,1,fail
9052,1,True,102,16,118,7,1,fail
9053,1,True,140,108,248,11,1,fail
9054,1,True,4,1,5,1,1,fail
9055,1,True,693,0,693,5,1,fail
9056,1,True,13,36,49,1,1,fail
9057,1,True,5,2,7,1,1,fail
9058,1,True,1,1,2,1,1,fail
9059,1,True,95,55,150,4,1,fail
9060,1,True,47,11,58,2,1,fail
9061,1,True,67,45,112,1,1,fail
9062,1,True,4,13,17,3,1,fail
9063,1,True,155,29,184,2,1,pass
9064,1,True,27,2,29,1,1,fail
9065,1,True,1760,442,2202,22,2,fail
9066,1,True,17,1,18,2,1,fail
9067,1,True,3,2,5,1,1,fail
9068,1,True,2,2,4,1,1,fail
9069,1,True,191,208,399,10,2,fail
9070,1,True,14,9,23,3,1,fail
9078,1,True,2,1,3,1,1,fail
9079,1,True,2,2,4,1,1,fail
9080,1,True,248,44,292,5,1,fail
9081,1,True,10,3,13,1,1,fail
9082,1,True,6,10,16,3,1,fail
9083,1,True,1,14,15,1,1,fail
9084,1,True,280,91,371,5,1,fail
9085,1,True,50,35,85,5,2,fail
9086,1,True,4,1,5,1,1,fail
9087,1,True,14,0,14,1,1,fail
9088,1,False,2,2,4,1,1,fail
9089,1,True,10,7,17,2,1,fail
9090,1,True,13,31,44,1,1,fail
9091,1,True,4,3,7,1,1,fail
9096,1,True,20,25,45,4,1,fail
9097,1,True,3,3,6,1,1,fail
9098,1,True,1,2,3,1,1,fail
9100,1,True,2,1,3,1,1,fail
9104,1,True,40,0,40,1,1,fail
9105,1,True,80,15,95,1,1,fail
9106,1,True,12,11,23,2,1,fail
9107,1,True,31,2,33,2,1,fail
9108,1,True,3,3,6,1,1,fail
9116,1,True,7,1,8,1,1,fail
9117,1,True,1,1,2,1,1,fail
9118,1,True,52,3,55,1,1,fail
9119,1,True,4,2,6,1,1,fail
9120,1,True,16,16,32,5,1,fail
9121,1,True,42,40,82,7,1,fail
9122,1,True,4,1,5,1,1,fail
9123,1,True,4764,1897,6661,77,2,fail
9124,1,True,16,5,21,1,1,fail
9125,1,True,17,0,17,3,1,fail
9126,1,True,64,36,100,4,1,fail
9127,1,True,206,60,266,5,1,fail
9128,1,True,59,0,59,1,1,fail
9129,1,True,5,8,13,1,1,fail
9130,1,True,38,11,49,3,1,fail
9131,1,True,2,2,4,1,1,fail
9133,1,True,1,1,2,1,1,fail
9134,1,True,15,5,20,2,1,fail
9135,1,True,53,0,53,2,1,fail
9136,1,True,4,4,8,1,1,fail
9137,1,True,4,0,4,1,1,pass
9138,1,True,0,29,29,1,1,fail
9140,1,True,1,4,5,1,1,fail
9141,1,True,202,15,217,4,1,fail
9142,1,True,57,17,74,2,1,fail
9143,1,True,45,1,46,1,1,fail
9144,1,True,4,1,5,1,1,fail
9145,1,True,1,1,2,1,1,fail
9146,1,True,0,1,1,1,1,fail
9147,1,True,1,0,1,1,1,fail
9148,1,True,71,41,112,3,1,fail
9149,1,True,0,0,0,2,1,fail
9150,1,True,57,4,61,4,2,fail
9151,1,True,0,0,0,1,1,fail
9152,1,True,491,129,620,4,1,fail
9153,1,True,21,0,21,1,1,fail
9154,1,True,53,51,104,2,1,fail
9155,1,True,137,15,152,10,1,fail
9156,1,True,20,0,20,1,1,fail
9157,1,True,7,6,13,1,1,fail
9158,1,True,5,0,5,1,1,fail
9159,1,True,4,4,8,1,1,fail
9160,1,True,116,0,116,1,1,fail
9161,1,True,10,0,10,2,1,fail
9162,1,True,4,5,9,4,1,fail
9163,1,True,34,10,44,4,1,fail
9164,1,True,138,47,185,1,1,fail
9165,1,True,10631,1246,11877,96,4,fail
9166,1,True,2614,29,2643,19,2,fail
9167,1,True,21,0,21,1,1,fail
9168,1,True,42,27,69,1,1,fail
9169,1,True,2,1,3,1,1,pass
9170,1,True,18,0,18,3,1,pass
9171,1,True,1,1,2,1,1,pass
9172,1,True,223,0,223,1,1,pass
9173,1,True,1387,16,1403,10,3,fail
9174,1,True,3,3,6,1,1,pass
9175,1,True,86,1,87,3,1,pass
9176,1,True,1,1,2,1,1,pass
9177,1,True,6,6,12,3,1,fail
9178,1,True,2,3,5,1,1,pass
9179,1,True,3,6,9,2,1,pass
9180,1,True,38,67,105,4,1,fail
9181,1,True,142,20,162,6,1,fail
9182,1,True,0,0,0,1,1,pass
9183,1,True,1491,28,1519,13,3,fail
9184,1,True,208,0,208,1,1,pass
9185,1,True,0,7,7,1,1,fail
9186,1,True,137,56,193,5,1,fail
9187,1,True,8,4,12,2,1,fail
9188,1,True,1,0,1,1,1,fail
9189,1,True,7,1,8,3,1,fail
9190,1,True,4,3,7,1,1,fail
9191,1,True,12,0,12,1,1,fail
9192,1,True,337,15,352,6,1,fail
9193,1,True,88,8,96,2,1,fail
9194,1,True,6,5,11,1,1,fail
9195,1,True,3642,155,3797,35,6,fail
9196,1,True,3,1,4,1,1,fail
9197,1,True,38,6026,6064,4,4,fail
9198,1,True,199,59,258,10,3,fail
9199,1,True,2,11,13,2,1,fail
9200,1,True,25,3,28,3,1,fail
9201,1,True,15,0,15,1,1,fail
9202,1,True,21,7,28,5,1,fail
9203,1,True,38,2,40,1,1,fail
9204,1,True,47,7,54,3,1,fail
9205,1,True,4,0,4,1,1,pass
9206,1,True,5,0,5,1,1,pass
9207,1,True,14,14,28,6,1,pass
9208,1,True,27,18,45,1,1,pass
9209,1,True,1,1,2,1,1,pass
9210,1,True,85,2,87,7,1,pass
9211,1,True,1,1,2,1,1,pass
9212,1,True,398,166,564,4,1,pass
9213,1,True,877,29,906,14,4,pass
9214,1,True,70,28,98,3,1,pass
9215,1,True,2,3,5,1,1,pass
9216,1,True,26,16,42,1,1,pass
9217,1,True,1,2,3,1,1,pass
9218,1,True,6,1,7,1,1,pass
9219,1,True,3,0,3,1,1,pass
9220,1,True,1100,76,1176,18,4,pass
9221,1,True,2,1,3,1,1,pass
9222,1,True,1,1,2,1,1,pass
9223,1,True,2,3,5,1,1,pass
9224,1,True,42,0,42,1,1,pass
9225,1,True,85,4,89,3,1,pass
9226,1,True,12,12,24,1,1,pass
9227,1,True,6,6,12,1,1,pass
9228,1,True,1,1,2,1,1,fail
9229,1,True,16,3,19,1,1,fail
9230,1,True,2,2,4,1,1,fail
9231,1,True,3,3,6,1,1,pass
9232,1,True,3,3,6,3,1,pass
9233,1,True,1,1,2,1,1,pass
9234,1,True,55,256,311,4,1,fail
9235,1,True,10,0,10,1,1,pass
9236,1,True,129,100,229,9,1,pass
9237,1,True,70,50,120,1,1,pass
9238,1,True,534,42,576,8,3,fail
9239,1,True,2,2,4,1,1,fail
9240,1,True,2,4,6,1,1,fail
9241,1,True,472,21,493,5,1,pass
9242,1,True,6,1,7,1,1,pass
9243,1,True,9,8,17,4,1,fail
9245,1,True,2,1,3,1,1,fail
9246,1,True,542,0,542,1,1,fail
9247,1,True,3,8,11,1,1,pass
9248,1,True,1,1,2,1,1,pass
9249,1,True,20,76,96,2,1,pass
9250,1,True,2,1,3,1,1,pass
9251,1,True,44,13,57,5,1,pass
9252,1,True,4,0,4,1,1,pass
9253,1,True,59,60,119,1,1,fail
9254,1,True,3,1,4,1,1,pass
9255,1,True,107,63,170,7,1,fail
9256,1,True,1,1,2,1,1,fail
9257,1,True,8,0,8,2,1,fail
9258,1,True,1,1,2,1,1,fail
9259,1,True,2,0,2,1,1,fail
9260,1,True,23,0,23,1,1,pass
9261,1,True,6,3,9,1,1,pass
9262,1,True,92,44,136,3,1,fail
9263,1,True,90,0,90,1,1,pass
9264,1,True,1,1,2,1,1,fail
9265,1,True,61,22,83,6,2,pass
9266,1,True,13,42,55,5,1,fail
9267,1,True,12,0,12,2,1,pass
9268,1,True,4,3,7,1,1,pass
9269,1,True,2,0,2,1,1,pass
9270,1,True,41,13,54,5,1,pass
9271,1,True,2,0,2,1,1,pass
9272,1,True,30,4,34,1,1,pass
9273,1,True,1,1,2,1,1,fail
9275,1,True,1,1,2,1,1,fail
9276,1,True,107,0,107,1,1,fail
9277,1,True,3,3,6,1,1,fail
9278,1,True,1,1,2,1,1,pass
9279,1,True,10,7,17,3,1,pass
9280,1,True,285,66,351,6,1,pass
9281,1,True,1,5,6,1,1,pass
9282,1,True,100,0,100,1,1,fail
9283,1,True,45,2,47,3,1,pass
9284,1,True,1,5,6,1,1,pass
9285,1,True,100,0,100,1,1,fail
9286,1,True,45,2,47,3,1,pass
9287,1,True,1,1,2,1,1,fail
9288,1,True,30,0,30,1,1,fail
9289,1,True,1,1,2,1,1,fail
9290,1,True,13,13,26,2,1,fail
9291,1,True,1,1,2,1,1,fail
9292,1,True,1,1,2,1,1,fail
9293,1,True,18,0,18,1,1,fail
9294,1,True,13,10,23,3,1,pass
9295,1,True,27,18,45,2,1,fail
9296,1,True,336,111,447,9,2,pass
9297,1,True,2,83,85,1,1,pass
9298,1,True,21,6,27,2,1,pass
9299,1,True,63,7,70,4,1,fail
9300,1,True,24,8,32,3,1,fail
9301,1,True,31,9,40,2,1,pass
9302,1,True,4,1,5,2,1,pass
9303,1,True,23,9,32,3,1,fail
9304,1,True,16,2,18,3,1,pass
9305,1,True,3,2,5,1,1,fail
9306,1,True,4,5,9,1,1,pass
9307,1,True,4,6,10,1,1,pass
9308,1,True,89,9,98,2,1,fail
9309,1,True,8381,2431,10812,94,7,pass
9310,1,True,5,1,6,1,1,pass
9311,1,True,3667,136,3803,47,4,pass
9312,1,True,26,6,32,3,1,fail
9313,1,True,73,0,73,1,1,pass
9314,1,True,7,5,12,1,1,fail
9315,1,True,22,10,32,2,1,fail
9316,1,True,76,25,101,6,1,fail
9317,1,True,594,239,833,11,2,fail
9318,1,True,83,0,83,2,1,fail
9319,1,True,1,1,2,1,1,pass
9320,1,True,2,4,6,1,1,fail
9321,1,True,13,17,30,1,1,pass
9322,1,True,41,20,61,5,1,pass
9323,1,True,0,6,6,1,1,fail
9324,1,True,5800,0,5800,29,4,fail
9325,1,True,2,3,5,2,1,fail
9326,1,True,3,3,6,1,1,fail
9327,1,True,2215,727,2942,34,3,fail
9328,1,True,0,0,0,0,0,fail
9329,1,True,19,14,33,2,1,fail
9330,1,True,2,2,4,1,1,fail
9331,1,True,14,5,19,3,1,fail
9332,1,True,45,24,69,3,1,fail
9333,1,True,123,51,174,3,1,fail
9334,1,True,1,1,2,1,1,fail
9335,1,True,42,4,46,3,1,fail
9336,1,True,4,0,4,1,1,pass
9337,1,True,0,0,0,1,1,pass
9338,1,True,14,12,26,2,1,fail
9339,1,True,3,1,4,1,1,fail
9340,1,True,2,0,2,2,1,pass
9341,1,True,14,17,31,1,1,fail
9342,1,True,1,1,2,1,1,fail
9343,1,True,17,0,17,1,1,fail
9344,1,True,38,9,47,3,1,fail
9347,1,True,11,2,13,3,1,pass
9348,1,True,102,56,158,11,1,pass
9349,1,True,19,7,26,2,1,pass
9350,1,True,1,1,2,1,1,pass
9351,1,True,28,18,46,1,1,fail
9352,1,True,4,2,6,2,1,pass
9353,1,True,29,23,52,6,1,fail
9354,1,True,6,6,12,2,1,fail
9355,1,True,1,1,2,1,1,fail
9356,1,True,1,1,2,1,1,fail
9357,1,True,78,1,79,4,1,fail
9358,1,True,266,251,517,34,1,fail
9359,1,True,251,266,517,34,1,pass
9360,1,True,2,2,4,1,1,fail
9361,1,True,266,251,517,34,1,fail
9362,1,True,2,2,4,2,1,pass
9363,1,True,1,1,2,1,1,pass
9364,1,True,207,125,332,4,1,pass
9365,1,True,4,2,6,2,1,pass
9366,1,True,6,0,6,1,1,pass
9367,1,True,1,1,2,1,1,pass
9368,1,True,143,48,191,1,1,pass
9369,1,True,14,18,32,4,1,pass
9370,1,True,268,87,355,2,1,pass
9371,1,True,7,4,11,2,1,fail
9372,1,True,12,2,14,1,1,pass
9373,1,True,1,1,2,1,1,fail
9374,1,True,5,4,9,3,1,pass
9375,1,True,1,1,2,1,1,pass
9376,1,True,0,2,2,1,1,pass
9377,1,True,1492,20,1512,10,2,pass
9378,1,True,24,17,41,3,3,pass
9379,1,True,2,2,4,1,1,pass
9380,1,True,48,8,56,2,1,pass
9381,1,True,1,5412,5413,31,4,pass
9382,1,True,4,5,9,1,1,pass
9383,1,True,16,11,27,1,1,pass
9384,1,True,0,6,6,1,1,fail
9385,1,True,1,0,1,1,1,fail
9386,1,True,1,0,1,1,1,pass
9387,1,True,20,0,20,2,1,pass
9388,1,True,84,16,100,4,1,fail
9389,1,True,93,15,108,2,1,fail
9390,1,True,106,2,108,3,1,pass
9391,1,True,19,18,37,3,1,pass
9392,1,True,24,11,35,4,1,fail
9393,2,True,1558,2276,3834,16,4,fail
9394,1,True,1,1,2,1,1,pass
9395,1,True,5,1,6,1,1,pass
9396,1,True,1,1,2,1,1,pass
9397,1,True,3,3,6,1,1,pass
9398,1,True,11,11,22,1,1,fail
9399,1,True,1,1,2,1,1,fail
9400,1,True,5,5,10,1,1,fail
9401,1,True,5,5,10,1,1,fail
9402,1,True,6,8,14,1,1,fail
9403,1,True,1,1,2,1,1,fail
9404,1,True,5,10,15,1,1,pass
9405,1,True,10,5,15,1,1,fail
9406,2,True,1,1,2,1,1,fail
9407,1,True,0,2,2,1,1,fail
9408,2,True,2,1,3,1,1,fail
9409,1,True,2,3,5,1,1,fail
9410,1,True,2,25,27,1,1,pass
9411,1,True,15,27,42,4,2,pass
9412,1,True,21,15,36,1,1,pass
9413,1,True,4,0,4,1,1,pass
9414,1,True,1,6,7,2,2,pass
9415,1,True,250,35,285,6,2,pass
9416,1,True,1,1,2,1,1,pass
9417,1,True,65,55,120,3,1,pass
9418,1,True,2,4,6,1,1,pass
9419,1,True,6,9,15,2,1,pass
9420,1,True,1320,2227,3547,14,3,pass
9421,1,True,2,2,4,1,1,fail
9422,2,True,9,2879,2888,16,7,fail
9423,1,True,9,2879,2888,16,7,fail
9424,2,True,1,1,2,1,1,fail
9425,1,True,1,1,2,1,1,pass
9426,2,True,0,2,2,1,1,fail
9427,1,True,2,1,3,1,1,fail
9428,2,True,35,12,47,3,1,fail
9429,1,True,26,2,28,3,1,fail
9430,1,True,12,13,25,2,1,pass
9431,1,True,1,1,2,1,1,pass
9432,2,True,17,2,19,1,1,pass
9433,1,True,17,2,19,1,1,pass
9434,2,True,1332,32,1364,12,1,fail
9435,1,True,7,7,14,4,1,fail
9436,1,True,4,4,8,1,1,pass
9437,1,True,9,49,58,4,1,fail
9438,1,True,2,1,3,1,1,pass
9439,1,True,4,4,8,1,1,fail
9440,1,True,4,2,6,1,1,fail
9441,1,True,11,9,20,1,1,fail
9442,1,True,1,3,4,2,1,fail
9443,1,True,38,37,75,1,1,fail
9444,1,True,154,34,188,4,1,fail
9445,1,True,2,2,4,1,1,pass
9446,1,True,1,1,2,1,1,fail
9447,2,True,0,0,0,0,0,fail
9448,1,True,80,59,139,2,1,pass
9449,1,True,87,107,194,7,1,pass
9450,1,True,73,50,123,1,1,fail
9451,1,True,6,8,14,1,1,fail
9452,1,True,63,80,143,3,1,fail
9453,1,True,63,44,107,1,1,fail
9454,1,True,19,1,20,2,1,fail
9455,1,True,11,7,18,3,1,fail
9456,1,True,38,19,57,6,1,fail
9457,1,True,15,4,19,1,1,fail
9458,1,True,77,104,181,6,1,fail
9459,1,True,0,0,0,0,0,pass
9460,1,True,1,1,2,1,1,pass
9462,1,True,1,1,2,1,1,pass
9463,1,True,1,1,2,1,1,pass
9464,2,True,305,798,1103,3,1,fail
9465,1,True,34,2,36,2,1,pass
9466,1,True,47,106,153,5,1,pass
9467,1,True,306,799,1105,3,1,fail
9468,1,True,1,1,2,1,1,fail
9469,1,True,4,5,9,2,1,fail
9470,1,True,0,2,2,1,1,pass
9471,1,True,2,2,4,1,1,pass
9472,1,True,18,15,33,3,1,pass
9473,1,True,0,1,1,1,1,pass
9474,1,True,27,22,49,3,1,fail
9475,1,True,188,669,857,4,1,pass
9476,1,True,9,9,18,1,1,pass
9477,1,True,426,0,426,1,1,pass
9478,2,True,2732,1220,3952,66,4,fail
9479,2,True,7754,17140,24894,189,30,pass
9480,2,True,6,4,10,2,1,fail
9481,1,True,6,4,10,2,1,pass
9482,2,True,262,5,267,2,1,pass
9483,1,True,44,65,109,1,1,pass
9484,2,True,253,5,258,2,1,pass
9485,1,True,9,0,9,1,1,pass
9486,2,True,174,44,218,3,1,pass
9487,1,True,253,5,258,2,1,pass
9488,2,True,9,14,23,2,1,pass
9489,1,True,53,39,92,1,1,pass
9490,1,True,4,1,5,1,1,pass
9491,1,True,113,0,113,1,1,pass
9492,2,True,2,0,2,1,1,pass
9493,1,True,5,12,17,1,1,pass
9494,1,True,2,0,2,1,1,pass
9495,2,True,7760,171,7931,51,3,fail
9496,1,True,7760,171,7931,51,3,pass
9497,1,True,17,6,23,1,1,pass
9498,2,True,2,17047,17049,131,28,pass
9499,1,True,0,4,4,1,1,pass
9500,1,True,2,17043,17045,130,27,pass
9501,2,True,6,6,12,7,2,pass
9502,2,True,6,6,12,7,2,pass
9503,2,True,17081,1743,18824,205,29,pass
9504,1,True,6,6,12,7,2,pass
9505,1,True,4,4,8,1,1,pass
9506,1,True,33,20,53,2,1,pass
9507,1,True,1,0,1,1,1,pass
9508,1,True,19,7,26,1,1,pass
9509,1,True,1,1,2,1,1,pass
9510,1,True,0,5,5,1,1,pass
9511,1,True,5,0,5,1,1,pass
9512,2,True,2,3,5,1,1,fail
9513,1,True,2,3,5,1,1,pass
9514,1,True,2479,1168,3647,51,4,pass
9515,1,True,253,52,305,15,1,pass
9516,1,True,624,2,626,3,1,pass
9517,2,True,623,558,1181,81,20,fail
9518,1,True,1,1,2,1,1,fail
9519,1,True,422,374,796,14,3,pass
9520,1,True,74,72,146,36,7,pass
9521,1,True,127,112,239,31,11,pass
9522,2,True,5,3,8,2,2,fail
9523,1,True,3,1,4,1,1,fail
9524,1,True,3,3,6,1,1,pass
9525,1,True,769,0,769,3,1,pass
9526,1,True,2,2,4,1,1,pass
9527,1,True,146,80,226,22,4,fail
9528,1,True,1,1,2,1,1,pass
9529,1,True,89,23,112,5,2,pass
9530,1,True,56,56,112,19,2,pass
9531,2,True,4047,1,4048,30,5,fail
9532,1,True,1,1,2,1,1,pass
9533,1,True,6,6,12,1,1,fail
9534,1,True,1,1,2,1,1,fail
9535,1,True,2,0,2,1,1,pass
9536,2,True,7,5,12,2,2,fail
9537,2,True,1,0,1,1,1,pass
9538,2,True,142,0,142,1,1,pass
9539,2,True,3864,0,3864,15,4,fail
9540,1,True,3864,0,3864,15,4,pass
9541,2,True,3,2,5,1,1,fail
9542,1,True,1,1,2,1,1,pass
9543,1,True,3,2,5,1,1,pass
9544,1,True,1,1,2,1,1,pass
9545,1,True,1,1,2,1,1,fail
9546,1,True,3,3,6,1,1,fail
9547,2,True,1,1,2,1,1,fail
9548,1,True,3,4,7,1,1,pass
9549,1,True,1,1,2,1,1,pass
9550,1,True,8,5,13,2,2,pass
9551,1,True,1,1,2,1,1,fail
9552,2,True,20,20,40,6,1,fail
9553,1,True,20,20,40,6,1,pass
9554,2,True,3,3,6,1,1,pass
9555,1,True,3,3,6,1,1,pass
9556,2,True,20,20,40,6,1,fail
9557,1,True,20,20,40,6,1,pass
9558,1,True,35,15,50,5,1,pass
9559,1,True,11727,979,12706,83,6,fail
9560,2,True,1,6,7,1,1,fail
9561,1,True,154,36,190,5,1,fail
9562,1,True,1,6,7,1,1,pass
9563,2,True,1,1,2,1,1,fail
9564,1,True,1,1,2,1,1,pass
9565,1,True,2,1,3,2,2,pass
9566,1,True,23,13,36,1,1,fail
9567,1,True,79,44,123,2,1,fail
9568,1,True,373,95,468,5,1,pass
9569,1,True,50,4,54,5,1,fail
9570,1,True,10,5,15,1,1,fail
9571,2,True,4,3,7,1,1,fail
9572,1,True,1,1,2,1,1,fail
9573,1,True,3,2,5,1,1,pass
9574,2,True,2,1,3,1,1,pass
9575,1,True,13,0,13,1,1,pass
9576,1,True,2,1,3,1,1,pass
9577,1,True,14,11,25,1,1,fail
9578,1,True,5,0,5,1,1,pass
9579,1,True,38,8,46,2,1,pass
9580,1,True,3,3,6,1,1,pass
9581,1,True,120,0,120,1,1,pass
9582,1,True,42,15,57,2,1,pass
9583,1,True,3,1,4,1,1,pass
9584,1,True,3848,0,3848,27,3,pass
9585,1,True,3,3,6,1,1,fail
9586,1,True,2,2,4,1,1,fail
9587,1,True,421,55,476,7,3,fail
9588,1,True,1,0,1,1,1,pass
9589,1,True,97,206,303,2,1,pass
9590,1,True,125,0,125,2,1,pass
9591,1,True,126,0,126,1,1,pass
9592,1,True,26,10,36,4,1,pass
9593,1,True,7,1,8,1,1,pass
9594,1,True,328,355,683,6,2,pass
9595,2,True,136,35,171,5,1,pass
9596,2,True,0,3,3,1,1,fail
9597,1,True,0,3,3,1,1,pass
9598,2,True,59,33,92,1,1,fail
9599,1,True,1,1,2,1,1,pass
9600,1,True,3,4,7,1,1,fail
9601,1,True,63,36,99,1,1,pass
9602,2,True,3984,444,4428,59,9,fail
9603,1,True,2472,387,2859,22,6,pass
9604,1,True,19,12,31,3,2,pass
9605,1,True,701,0,701,4,2,pass
9606,1,True,248,0,248,2,1,pass
9607,1,True,88,99,187,25,1,pass
9608,1,True,76,101,177,17,1,pass
9609,1,True,91,43,134,1,1,pass
9610,1,True,162,129,291,6,3,pass
9611,1,True,3,3,6,1,1,pass
9612,1,True,152,28,180,3,1,pass
9613,1,True,0,2,2,1,1,pass
9614,1,True,147,18,165,5,2,pass
9615,1,True,5,2,7,1,1,pass
9616,1,True,13,9,22,2,1,pass
9617,1,True,127,52,179,2,1,pass
9618,1,True,53,25,78,2,1,pass
9619,1,True,78,5,83,2,1,pass
9620,1,True,1,7,8,1,1,pass
9621,1,True,15,4,19,2,2,pass
9622,1,True,57,42,99,3,2,pass
9623,1,True,34,18,52,3,1,fail
9624,1,True,1,1,2,1,1,pass
9625,1,True,8,12,20,1,1,fail
9626,1,True,3,3,6,1,1,fail
9627,1,True,61,49,110,2,1,fail
9628,1,True,1,2,3,1,1,fail
9629,1,True,1,1,2,1,1,pass
9630,1,True,1,1,2,1,1,pass
9631,1,True,18,16,34,2,1,pass
9632,1,True,135,44,179,3,1,pass
9633,1,True,2,2,4,1,1,fail
9634,2,True,99,49,148,5,1,fail
9635,2,True,149,28,177,6,1,fail
9636,1,True,9,1,10,2,1,fail
9637,2,True,2,2,4,1,1,pass
9638,1,True,2,2,4,1,1,pass
9639,1,True,2,2,4,1,1,fail
9640,1,True,49,91,140,2,1,fail
9641,1,True,8,1,9,1,1,fail
9642,2,True,7,7,14,1,1,fail
9643,1,True,7,7,14,1,1,pass
9644,1,True,26,0,26,1,1,fail
9645,1,True,113,18,131,3,1,pass
9646,1,True,1,0,1,1,1,fail
9647,1,True,125,49,174,4,1,fail
9648,2,True,1,5,6,1,1,fail
9649,1,True,1,5,6,1,1,pass
9650,2,True,10,20,30,1,1,pass
9651,1,True,10,20,30,1,1,pass
9652,2,True,771,162,933,12,3,pass
9653,1,True,2,0,2,1,1,pass
9654,1,True,3,1,4,1,1,pass
9655,1,True,17,12,29,5,4,fail
9656,1,True,4,2,6,1,1,pass
9657,1,True,35,13,48,1,1,pass
9658,1,True,18,11,29,5,1,pass
9659,2,True,22,0,22,1,1,pass
9660,2,True,28,20,48,1,1,pass
9661,1,True,28,20,48,1,1,pass
9662,2,True,2,2,4,1,1,fail
9663,1,True,18,8,26,3,2,pass
9664,1,True,363,238,601,9,2,pass
9665,1,True,2,2,4,1,1,pass
9666,1,True,19,1,20,2,1,pass
9667,2,True,1837,80,1917,27,3,fail
9668,2,True,31,2,33,1,1,fail
9669,1,True,3,5,8,1,1,pass
9670,2,True,2,2,4,1,1,pass
9671,2,True,2,1,3,1,1,pass
9672,1,True,43,3,46,2,1,pass
9673,1,True,22,0,22,1,1,pass
9674,1,True,1837,80,1917,27,3,pass
9675,1,True,7,6,13,1,1,fail
9676,1,True,751,156,907,12,3,pass
9677,1,True,100,29,129,10,2,fail
9678,1,True,2,5,7,1,1,pass
9679,1,True,36,2,38,1,1,fail
9680,2,True,54566,3051,57617,243,15,pass
9681,2,True,2243,0,2243,35,4,fail
9682,1,True,2,1,3,1,1,fail
9683,1,True,1252,763,2015,30,3,fail
9684,1,True,2243,0,2243,35,4,pass
9685,1,True,21943,1897,23840,100,6,pass
9686,1,True,2,2,4,1,1,fail
9687,2,True,6,3,9,1,1,pass
9688,2,True,1,1,2,1,1,fail
9689,1,True,1,1,2,1,1,fail
9690,1,True,153,33,186,6,2,pass
9691,2,True,2125,1,2126,11,3,pass
9692,2,True,264871,15558,280429,300,44,pass
9693,1,True,2124,0,2124,11,3,fail
9694,1,True,2,0,2,1,1,fail
9695,1,True,2,8,10,3,1,fail
9696,1,True,1,1,2,1,1,pass
9697,1,True,1,1,2,1,1,pass
9698,1,True,1,2,3,1,1,fail
9699,1,True,2,2,4,1,1,fail
9700,1,True,2,2,4,1,1,fail
9701,1,True,7,3,10,1,1,fail
9702,1,True,8,1,9,2,1,pass
9703,1,True,7642,0,7642,26,7,fail
9704,1,True,1,1,2,1,1,fail
9705,2,True,19,29,48,1,1,pass
9706,1,True,19,29,48,1,1,fail
9707,2,True,19727,922,20649,46,6,pass
9708,1,True,13,14,27,1,1,fail
9709,1,True,15,0,15,1,1,fail
9710,1,True,2,0,2,1,1,pass
9711,1,True,19724,935,20659,45,6,pass
9712,2,True,27,15,42,4,1,pass
9713,1,True,12,7,19,2,1,pass
9714,1,True,1,1,2,1,1,pass
9715,1,True,26,14,40,3,1,fail
9716,1,True,1,2,3,1,1,pass
9717,2,True,20,4,24,3,2,pass
9719,1,True,5,6,11,1,1,pass
9720,2,True,4,4,8,1,1,pass
9721,1,True,4,4,8,1,1,fail
9722,1,True,4,2,6,1,1,pass
9723,1,True,42,23,65,5,1,pass
9724,1,True,18,2,20,1,1,pass
9725,1,True,2,2,4,2,1,pass
9726,1,True,1,1,2,1,1,pass
9727,1,True,1,1,2,1,1,pass
9728,2,True,3,5,8,1,1,fail
9729,1,True,1,1,2,1,1,pass
9730,1,True,2,2,4,1,1,pass
9731,2,True,4,3,7,1,1,fail
9732,1,True,4,3,7,1,1,fail
9733,1,True,60,19,79,2,2,fail
9734,1,True,10,18,28,1,1,fail
9735,1,True,2,0,2,1,1,fail
9736,1,True,29,10,39,1,1,pass
9737,1,True,25,29,54,4,1,pass
9738,1,True,3,2,5,1,1,fail
9739,2,True,92,6330,6422,9,1,pass
9740,2,True,406,50,456,12,3,pass
9741,1,True,16,9,25,2,1,pass
9742,2,True,2,2,4,1,1,pass
9743,1,True,2,2,4,1,1,fail
9744,2,True,1,1,2,1,1,pass
9745,1,True,1,1,2,1,1,fail
9746,1,True,2,2,4,1,1,fail
9747,2,True,1,1,2,1,1,pass
9748,1,True,1,1,2,1,1,pass
9749,1,True,385,37,422,6,1,pass
9750,1,True,91,6330,6421,9,1,pass
9751,2,True,2,0,2,1,1,pass
9752,1,True,2,2,4,1,1,pass
9753,1,True,1,1,2,1,1,pass
9754,2,True,1,1,2,1,1,pass
9755,1,True,1,1,2,1,1,fail
9756,1,True,2,0,2,1,1,fail
9757,1,True,12,2,14,1,1,pass
9758,2,True,2,2,4,1,1,fail
9759,1,True,2,2,4,1,1,fail
9760,1,True,3,0,3,1,1,fail
9761,2,True,4,4,8,1,1,fail
9762,1,True,4,4,8,1,1,pass
9763,1,True,1,1,2,1,1,fail
9764,2,True,7,7,14,1,1,fail
9765,1,True,1,7,8,1,1,fail
9766,2,True,155,188,343,1,1,pass
9767,1,True,6,9,15,2,1,pass
9768,1,True,62,154,216,1,1,pass
9769,1,True,1,1,2,1,1,pass
9770,1,True,10,12,22,1,1,pass
9771,2,True,11,11,22,1,1,fail
9772,1,True,11,11,22,1,1,fail
9773,1,True,32,4,36,4,2,fail
9774,2,True,5,0,5,1,1,pass
9775,1,True,0,1001,1001,1,1,pass
9776,1,True,5,0,5,1,1,fail
9777,1,True,3,3,6,1,1,fail
9778,1,True,63,6,69,6,2,fail
9779,2,True,23,1,24,2,1,pass
9780,1,True,7,7,14,1,1,fail
9781,2,True,38,93,131,1,1,fail
9782,2,True,1199,1792,2991,4,3,pass
9783,1,True,2,2,4,1,1,fail
9784,1,True,0,0,0,1,1,fail
9785,1,True,0,0,0,2,1,pass
9786,1,True,165,97,262,1,1,pass
9787,1,True,1111,1772,2883,1,1,pass
9788,1,True,1,1,2,1,1,fail
9789,1,True,4,5,9,1,1,fail
9790,1,True,0,89836,89836,300,10,fail
9791,1,True,3,5,8,1,1,fail
9792,1,True,23,1,24,2,1,fail
9793,2,True,2,2,4,1,1,fail
9794,1,True,2,2,4,1,1,fail
9795,1,True,3102,1390,4492,59,4,fail
9796,2,True,1,1,2,1,1,fail
9797,1,True,1,1,2,1,1,fail
9798,2,True,36,32,68,1,1,fail
9799,2,True,2,2,4,1,1,fail
9800,1,True,2,2,4,1,1,pass
9801,2,True,1,1,2,1,1,pass
9802,1,True,38,93,131,1,1,pass
9803,2,True,0,0,0,0,0,pass
9804,1,True,34,33,67,1,1,pass
9805,1,True,2,3,5,1,1,fail
9806,1,True,39,47,86,2,1,pass
9807,2,True,1284,0,1284,2,2,fail
9808,1,True,2,2,4,1,1,fail
9809,1,True,4,4,8,1,1,fail
9810,1,True,2,2,4,1,1,fail
9811,1,True,1281,1295,2576,1,1,fail
9812,1,True,0,13,13,1,1,fail
9813,1,True,19,2,21,1,1,pass
9814,1,True,4,5,9,1,1,pass
9815,1,True,1,11,12,1,1,pass
9816,1,True,32,413,445,1,1,pass
9817,1,True,1680,1539,3219,1,1,pass
9818,1,True,1,1,2,1,1,fail
9819,1,True,0,0,0,1,1,pass
9820,1,True,14,18,32,2,2,fail
9821,1,True,105,447,552,1,1,fail
9822,1,True,5062,2175,7237,80,5,fail
9823,1,True,15,1,16,1,1,fail
9824,1,True,4,6,10,1,1,fail
9825,2,True,1,1,2,1,1,pass
9826,2,True,0,456,456,1,1,pass
9827,1,True,0,456,456,1,1,pass
9828,1,True,2260,0,2260,5,4,pass
9829,1,True,4,1,5,1,1,pass
9830,1,True,5,2,7,1,1,pass
9831,1,True,1,1,2,1,1,pass
9832,1,True,53,2,55,1,1,fail
9833,2,True,116,55,171,1,1,pass
9834,1,True,116,55,171,1,1,pass
9835,1,True,1001,0,1001,1,1,pass
9836,1,True,8,3,11,1,1,pass
9837,2,True,4,4,8,1,1,pass
9838,1,True,28,10,38,3,1,pass
9839,1,True,2,1,3,1,1,fail
9840,1,True,0,1,1,1,1,pass
9841,1,True,1,1,2,1,1,pass
9842,2,True,6,0,6,1,1,pass
9843,1,True,1767,944,2711,18,5,fail
9844,1,True,6,0,6,1,1,fail
9845,1,True,1,1,2,1,1,pass
9846,1,True,1,6,7,1,1,fail
9847,2,True,1,0,1,1,1,pass
9848,1,True,6,5,11,1,1,pass
9849,1,True,5,5,10,1,1,fail
9850,2,True,19,20,39,1,1,pass
9851,2,True,5,5,10,1,1,pass
9852,1,True,5,5,10,1,1,fail
9853,1,True,19,20,39,1,1,pass
9854,2,True,1688,0,1688,9,4,fail
9855,1,True,7,9,16,1,1,fail
9856,1,True,1842,0,1842,1,1,fail
9857,1,True,257,19,276,12,2,pass
9858,1,True,6,3,9,1,1,fail
9859,2,True,20,4,24,1,1,pass
9860,2,True,100,36,136,7,2,fail
9861,2,True,370,0,370,1,1,fail
9862,2,True,1,1,2,1,1,pass
9863,1,True,1,1,2,1,1,pass
9864,1,True,1688,0,1688,9,4,pass
9865,1,True,1,1,2,1,1,fail
9866,1,True,2,1,3,1,1,fail
9867,1,True,2,2,4,1,1,pass
9868,1,True,102,38,140,8,3,pass
9869,2,True,2,2,4,1,1,fail
9870,2,True,4290,0,4290,40,4,pass
9871,1,True,1,1,2,1,1,pass
9872,1,True,2,2,4,1,1,pass
9873,1,True,1,1,2,1,1,pass
9874,1,True,1,1,2,1,1,pass
9875,1,True,4,3,7,1,1,pass
9876,1,True,2,2,4,1,1,pass
9877,1,True,3,3,6,1,1,pass
9878,1,True,3,2,5,1,1,pass
9879,1,True,2,2,4,1,1,pass
9880,1,True,7,5,12,1,1,pass
9881,1,True,2,2,4,1,1,pass
9882,1,True,2,1,3,1,1,pass
9883,1,True,3,1,4,1,1,pass
9884,1,True,2,2,4,1,1,pass
9885,1,True,1,3,4,1,1,pass
9886,1,True,1,1,2,1,1,pass
9887,1,True,4,4,8,1,1,pass
9888,1,True,4285,0,4285,40,4,pass
9889,1,True,0,1,1,1,1,fail
9890,1,True,4,4,8,1,1,fail
9891,1,True,8,3,11,1,1,fail
9892,1,True,2,0,2,1,1,fail
9893,2,True,2,2,4,1,1,pass
9894,2,True,5,5,10,2,1,pass
9895,1,True,0,9,9,1,1,fail
9896,1,True,2,2,4,1,1,pass
9897,1,True,40,56,96,1,1,fail
9898,1,True,163,252,415,6,2,fail
9899,1,True,390,0,390,1,1,fail
9900,2,True,4,3,7,1,1,fail
9901,1,True,1,1,2,1,1,pass
9902,1,True,45,18,63,2,1,pass
9903,1,True,3,3,6,1,1,pass
9904,1,True,2,2,4,1,1,pass
9905,1,True,2,2,4,1,1,fail
9906,2,True,309,61,370,1,1,pass
9907,1,True,15,13,28,1,1,pass
9908,1,True,2,2,4,1,1,pass
9909,1,True,27,27,54,1,1,pass
9910,2,True,4,2,6,1,1,pass
9911,2,True,5,4,9,1,1,fail
9912,1,True,4,2,6,1,1,pass
9913,1,True,2,2,4,1,1,pass
9914,1,True,1,1,2,1,1,pass
9915,1,True,1,97,98,1,1,pass
9916,2,True,3,3,6,1,1,pass
9917,2,True,1,1,2,1,1,pass
9918,1,True,1,12,13,1,1,pass
9919,1,True,15,4,19,1,1,pass
9920,1,True,1,1,2,1,1,pass
9921,1,True,1,1,2,1,1,pass
9922,1,True,5,4,9,1,1,pass
9923,2,True,1,1,2,1,1,pass
9924,2,True,1,1,2,1,1,fail
9925,1,True,4,3,7,1,1,pass
9926,2,True,2,2,4,1,1,pass
9927,1,True,1,1,2,1,1,pass
9928,1,True,2,2,4,1,1,pass
9929,2,True,48,48,96,6,1,pass
9930,1,True,2,2,4,1,1,fail
9931,1,True,47,47,94,6,1,pass
9932,1,True,350,18,368,1,1,pass
9933,2,True,229,233,462,1,1,pass
9934,1,True,7,4,11,1,1,pass
9935,1,True,189,36,225,1,1,pass
9936,1,True,51,41,92,1,1,pass
9937,1,True,39,198,237,1,1,pass
9938,1,True,19,16,35,1,1,pass
9939,1,True,19,16,35,1,1,pass
9940,2,True,5,5,10,1,1,pass
9941,1,True,0,13,13,1,1,pass
9942,1,True,18,5,23,1,1,pass
9943,2,True,72,0,72,1,1,pass
9944,1,True,3,3,6,1,1,pass
9945,1,True,47,275,322,1,1,pass
9946,1,True,1,1,2,1,1,pass
9947,1,True,1,1,2,1,1,pass
9948,1,True,1,2,3,1,1,pass
9949,1,True,72,0,72,1,1,pass
9950,1,True,2,2,4,1,1,pass
9951,1,True,234,6,240,1,1,pass
9952,2,True,2,2,4,1,1,pass
9953,1,True,2,2,4,1,1,pass
9954,1,True,406,0,406,5,2,pass
9955,2,True,28,131,159,1,1,pass
9956,1,True,28,131,159,1,1,pass
9957,2,True,1404,0,1404,1,1,pass
9958,2,True,943,0,943,1,1,pass
9959,2,True,405,335,740,1,1,pass
9960,2,True,2,2,4,1,1,pass
9961,1,True,2,2,4,1,1,pass
9962,1,True,1,1,2,1,1,pass
9963,1,True,2,2,4,1,1,pass
9964,1,True,404,334,738,1,1,pass
9965,1,True,0,0,0,1,1,pass
9966,1,True,4,1,5,1,1,pass
9967,2,True,743,130,873,11,4,pass
9968,1,True,1,1,2,1,1,pass
9969,1,True,2,0,2,1,1,pass
9970,1,True,741,130,871,11,4,pass
9971,1,True,1,2,3,1,1,pass
9972,2,True,12,4,16,1,1,pass
9973,1,True,1,1,2,1,1,pass
9974,1,True,12,4,16,1,1,pass
9975,1,True,37,32,69,1,1,pass
9976,2,True,196,65,261,6,1,fail
9977,1,True,1,1,2,1,1,pass
9978,2,True,220,94,314,1,1,pass
9979,1,True,1,1,2,1,1,pass
9980,1,True,4,2,6,1,1,pass
9981,1,True,51,11,62,1,1,pass
9982,1,True,17,3,20,1,1,pass
9983,1,True,1,1,2,1,1,pass
9984,1,True,196,65,261,6,1,pass
9985,1,True,3797,167,3964,77,5,pass
9986,1,True,179,95,274,1,1,pass
9987,1,True,8,16,24,1,1,pass
9988,1,True,87,19,106,1,1,pass
9989,1,True,15,19,34,1,1,pass
9990,1,True,0,0,0,1,1,pass
9991,1,True,24,22,46,1,1,pass
9992,1,True,5,0,5,1,1,fail
9993,1,True,67,29,96,1,1,pass
9994,1,True,7,69,76,1,1,pass
9995,1,True,68,5,73,3,3,pass
9996,1,True,1,1,2,1,1,pass
9997,1,True,5,1,6,1,1,pass
9998,1,True,2,6,8,1,1,pass
9999,1,True,55,15,70,1,1,pass
10000,1,True,100,951,1051,1,1,pass
10001,1,True,2132,1706,3838,1,1,pass
10002,1,True,1271,180,1451,1,1,pass
10003,1,True,629,461,1090,2,2,pass
10004,1,True,461,0,461,1,1,pass
10005,2,True,3,3,6,2,2,pass
10006,1,True,3,3,6,2,2,pass
10007,2,True,1871,0,1871,11,3,fail
10008,2,True,1,1,2,1,1,pass
10009,1,True,1,1,2,1,1,pass
10010,1,True,6,6,12,1,1,pass
10011,1,True,5,3,8,4,3,pass
10012,1,True,548,496,1044,8,3,pass
10013,2,True,96,17,113,1,1,pass
10014,1,True,96,17,113,1,1,pass
10015,1,True,6,6,12,1,1,pass
10016,1,True,1871,0,1871,11,3,pass
10017,1,True,393,715,1108,1,1,pass
10018,1,True,1092,0,1092,1,1,pass
10019,1,True,4,4,8,1,1,pass
10020,2,True,4,4,8,3,1,pass
10021,1,True,1,1,2,1,1,pass
10022,1,True,2,2,4,1,1,pass
10023,1,True,1,1,2,1,1,pass
10024,1,True,411,136,547,4,1,pass
10025,2,True,1244,1154,2398,7,1,fail
10026,1,True,2,2,4,1,1,pass
10027,1,True,3,3,6,1,1,pass
10028,1,True,3,3,6,1,1,pass
10029,1,True,3,3,6,1,1,pass
10030,1,True,3,3,6,1,1,pass
10031,1,True,3,3,6,1,1,pass
10032,1,True,1,1,2,1,1,pass
10033,1,True,3,3,6,1,1,pass
10034,1,True,90,0,90,1,1,pass
10035,1,True,0,0,0,6,1,pass
10036,1,True,0,0,0,1,1,pass
10037,1,True,0,0,0,7,1,pass
10038,2,True,132,28,160,7,1,pass
10039,1,True,89836,0,89836,300,10,pass
10040,1,True,124,20,144,1,1,pass
10041,1,True,8,8,16,7,1,pass
10042,1,True,1873,750,2623,71,5,pass
10043,2,True,1,1,2,1,1,pass
10044,2,True,173,99,272,1,1,pass
10045,1,True,173,99,272,1,1,pass
10046,1,True,850,0,850,7,2,pass
10047,2,True,33,33,66,14,2,pass
10048,2,True,2804,0,2804,166,4,pass
10049,2,True,20,3,23,4,1,pass
10050,1,True,1,1,2,1,1,pass
10051,1,True,2804,0,2804,166,4,pass
10052,2,True,21,21,42,7,1,pass
10053,1,True,21,21,42,7,1,pass
10054,2,True,2,3,5,2,1,pass
10055,1,True,2,3,5,2,1,pass
10056,1,True,33,33,66,14,2,pass
10057,1,True,4,1,5,1,1,pass
10058,1,True,15,1,16,2,1,pass
10059,1,True,1,1,2,1,1,pass
10063,2,True,0,0,0,0,0,pass
10064,1,True,703,0,703,9,4,pass
10065,1,True,702,0,702,8,3,pass
10067,1,True,109,73,182,4,2,pass
10068,1,True,325,0,325,3,2,pass
10069,1,True,15,1,16,2,1,pass
10070,1,True,34,4,38,3,1,pass
10073,1,True,1773,1,1774,13,5,pass
10075,1,True,15,15,30,1,1,pass
10078,1,True,1,4,5,1,1,fail
10080,1,True,5,3,8,1,1,fail
10081,1,True,4,7,11,1,1,pass
10084,1,True,4,20,24,1,1,pass
10085,2,True,166,45,211,1,1,pass
10086,1,True,166,45,211,1,1,pass
10089,1,True,1,1,2,1,1,fail
10091,1,True,3,3,6,1,1,pass
10093,1,True,32,175,207,1,1,pass
10094,1,True,23,127,150,1,1,pass
10095,1,True,26,103,129,1,1,pass
10096,1,True,44,170,214,1,1,pass
10099,1,True,0,13,13,1,1,pass
10100,1,True,0,0,0,0,0,pass
10101,1,True,17,1,18,1,1,pass
10102,1,True,661,0,661,1,1,pass
10103,1,True,6,6,12,1,1,pass
10105,1,True,1,1,2,1,1,pass
10110,2,True,149,16,165,1,1,fail
10113,1,True,17,13,30,1,1,pass
10115,2,True,200,40,240,1,1,pass
10116,2,True,180,22,202,1,1,pass
10117,2,True,135,19,154,1,1,pass
10119,1,True,135,19,154,1,1,pass
10120,1,True,149,16,165,1,1,pass
10121,1,True,180,22,202,1,1,pass
10122,1,True,200,40,240,1,1,pass
10123,1,True,14,2,16,1,1,pass
10124,1,True,0,0,0,1,1,pass
10125,1,True,24,2,26,1,1,pass
10126,1,True,1,1,2,1,1,pass
10127,1,True,0,0,0,1,1,pass
10128,1,True,0,8,8,1,1,pass
10129,1,True,4,5,9,1,1,pass
10131,1,True,2,2,4,1,1,pass
10132,1,True,24,7,31,1,1,pass
10133,1,True,185,0,185,1,1,pass
10134,1,True,44,30,74,2,1,pass
10135,1,True,22,21,43,2,1,pass
10136,1,True,222,63,285,2,1,pass
10137,1,True,1,1,2,1,1,pass
10138,1,True,645,0,645,1,1,pass
10139,1,True,250,195,445,15,3,pass
10141,1,True,1,1,2,1,1,pass
10142,1,True,1,11,12,1,1,pass
10143,1,True,13,2,15,1,1,pass
10146,1,True,20,2,22,1,1,pass
10147,1,True,3387,0,3387,8,3,pass
10148,1,True,1,11,12,1,1,pass
10149,1,True,875,0,875,1,1,pass
10150,1,True,502,0,502,1,1,pass
10151,1,True,1,11,12,1,1,pass
10152,1,True,661,0,661,1,1,pass
10154,1,True,2,2,4,1,1,pass
10155,2,True,2,2,4,1,1,fail
10157,1,True,2,2,4,1,1,pass
10159,1,True,2,1,3,1,1,pass
10162,1,True,6,5,11,1,1,pass
10167,1,True,1,1,2,1,1,pass
10168,1,True,727,1,728,6,4,pass
10169,1,True,11,9,20,1,1,pass
10170,1,True,37,8,45,3,1,pass
10171,1,True,198,19,217,5,1,pass
10172,2,True,5315,464,5779,59,4,pass
10173,1,True,1658,0,1658,3,1,pass
10174,1,True,5315,2122,7437,62,4,pass
10175,2,True,13783,0,13783,38,13,pass
10176,1,True,167,52,219,3,2,pass
10178,1,True,2522,126,2648,39,2,fail
10179,1,True,2,2,4,1,1,pass
10180,1,True,2,2,4,1,1,pass
10181,1,True,1,1,2,1,1,pass
10182,1,True,13783,0,13783,38,13,pass
10195,1,True,1,1,2,1,1,pass
10198,1,True,1,1,2,1,1,pass
10200,2,True,249,126,375,1,1,pass
10202,1,True,20,16,36,3,2,pass
10203,1,True,249,126,375,1,1,pass
10204,1,True,99,23,122,1,1,pass
10206,1,True,1149,0,1149,1,1,pass
10208,1,True,2,2,4,1,1,pass
10209,1,True,2,3,5,1,1,pass
10210,1,True,1,11,12,1,1,pass
10211,1,True,0,0,0,0,0,pass
10213,1,True,69,22,91,1,1,pass
10215,1,True,1,1,2,1,1,pass
10219,1,True,2,2,4,1,1,pass
10221,1,True,9,9,18,1,1,pass
10224,1,True,1,1,2,1,1,pass
10229,1,True,8,4,12,3,1,pass
10230,1,True,3441,0,3441,29,4,pass
10232,1,True,2,2,4,1,1,pass
10235,1,True,3,10,13,1,1,pass
10236,1,True,2,2,4,1,1,pass
10237,1,True,2,2,4,1,1,pass
10238,1,True,3,3,6,1,1,pass
10239,1,True,6,0,6,1,1,pass
10240,1,True,1454,98,1552,20,3,pass
10246,1,True,9,2,11,1,1,pass
10248,1,True,2,2,4,1,1,pass
10252,1,True,8,7,15,1,1,pass
10254,1,True,1,1,2,1,1,pass
10255,1,True,1,1,2,1,1,pass
10256,1,True,10,11,21,1,1,pass
10257,1,True,297,150,447,1,1,pass
10258,1,True,2,3,5,1,1,pass
10259,1,True,8,1,9,1,1,pass
10266,1,True,0,144974,144974,298,32,pass
10268,1,True,1088,299,1387,42,4,pass
10271,1,True,40,25,65,2,1,pass
10276,1,True,1,1,2,1,1,fail
10277,1,True,12,10,22,2,1,pass
10278,1,True,244,198,442,2,1,pass
10279,1,True,525,326,851,3,1,pass
10280,1,True,53,67,120,2,2,pass
10281,2,True,14367,1695,16062,121,11,pass
10282,1,True,170,30,200,2,1,pass
10283,1,True,7,7,14,4,2,pass
10286,1,True,1,1,2,1,1,pass
10287,1,True,7,3,10,1,1,pass
10288,1,True,1,3,4,1,1,pass
10289,1,True,6,3,9,1,1,pass
10295,1,True,424,29,453,7,4,pass
10301,1,True,3,2,5,1,1,pass
10302,1,True,10638,0,10638,24,4,fail
10303,1,True,154211,2951,157162,300,34,pass
10304,1,True,7,2,9,1,1,pass
10305,1,True,1,1,2,1,1,pass
10307,1,True,3,3,6,1,1,pass
10308,1,True,1429,322,1751,40,5,fail
10309,1,True,15,1,16,1,1,pass
10312,1,True,6,6,12,1,1,pass
10314,1,True,1,0,1,1,1,pass
10315,1,True,1,0,1,1,1,pass
10316,1,True,1,0,1,1,1,pass
10317,1,True,35,0,35,1,1,pass
10318,1,True,1,1,2,1,1,pass
10319,1,True,78,0,78,1,1,pass
10326,1,True,3,1,4,3,1,pass
10331,1,True,1,1,2,1,1,pass
10334,1,True,39,37,76,5,1,pass
10336,1,True,35,72,107,5,1,pass
10341,1,True,1,1,2,1,1,pass
10352,1,True,3,3,6,1,1,pass
10354,2,True,5,2,7,2,2,fail
10356,1,True,1,1,2,1,1,pass
10358,1,True,1,1,2,1,1,pass
10359,1,True,82,6,88,2,1,pass
10360,1,True,316,0,316,2,1,pass
10361,1,True,100,21,121,5,2,pass
10362,1,True,61,76,137,2,1,pass
10363,1,True,31,30,61,2,1,pass
10364,1,True,2,1,3,1,1,pass
10365,1,True,2,1,3,1,1,pass
10366,1,True,50,46,96,2,1,pass
10367,1,True,40,9,49,4,1,pass
10368,1,True,5,5,10,2,2,pass
10369,1,True,13,5,18,1,1,pass
10370,1,True,17,16,33,2,2,pass
10371,1,True,20,22,42,1,1,pass
10372,1,True,73,34,107,6,2,pass
10373,1,True,7,1,8,1,1,pass
10374,1,True,576,459,1035,6,1,pass
10375,1,True,5,4,9,2,1,pass
10376,1,True,27,2,29,1,1,pass
10377,1,True,267,121,388,18,3,pass
10378,1,True,10,0,10,1,1,pass
10379,1,True,16,44,60,3,3,pass
10380,2,True,1123,396,1519,82,17,pass
10384,1,True,1,1,2,1,1,pass
10387,1,True,21,21,42,1,1,pass
10388,1,True,3,5,8,1,1,pass
10389,1,True,2,0,2,1,1,pass
10391,1,True,4,2,6,1,1,pass
10392,1,True,29,20,49,1,1,pass
10395,2,True,167,4,171,9,1,fail
10396,1,True,35,54,89,4,1,pass
10397,1,True,2,1,3,1,1,pass
10398,1,True,167,4,171,9,1,fail
10400,1,True,18,8,26,1,1,fail
10405,1,True,3,1,4,2,2,fail
10406,2,True,1,1,2,1,1,pass
10407,1,True,1,1,2,1,1,pass
10409,1,True,1,1,2,1,1,pass
10414,1,True,1,1,2,1,1,pass
10416,1,True,1,1,2,1,1,pass
10417,1,True,1,1,2,1,1,pass
10418,1,True,5,5,10,1,1,pass
10419,2,True,3735,40,3775,52,6,pass
10420,1,True,1301,528,1829,41,3,pass
10424,1,True,17,13,30,2,1,pass
10425,2,True,6490,287,6777,103,7,pass
10427,1,True,0,2,2,1,1,pass
10432,1,True,2785,3,2788,17,4,pass
10434,2,True,2631,6,2637,25,5,pass
10439,1,True,1,1,2,1,1,pass
10440,1,True,329,3,332,7,3,pass
10441,1,True,4,3,7,1,1,pass
10442,1,True,17,10,27,6,1,pass
10443,1,True,2,0,2,1,1,pass
10444,1,True,21,1,22,1,1,pass
10445,2,True,5135,148,5283,116,23,pass
10446,1,True,2623,0,2623,21,4,pass
10448,1,True,1,0,1,1,1,fail
10449,1,True,5,2,7,2,1,pass
10450,1,True,9,0,9,1,1,pass
10451,1,True,1,0,1,1,1,pass
10452,1,True,6,10,16,1,1,pass
10453,1,True,2,2,4,1,1,pass
10454,1,True,73,0,73,2,1,pass
10455,1,True,0,8,8,1,1,pass
10456,1,True,3,1,4,1,1,pass
10457,1,True,38,0,38,2,1,pass
10458,1,True,9,2,11,2,1,pass
10459,1,True,3,2,5,1,1,pass
10460,1,True,8,0,8,1,1,pass
10461,1,True,2,2,4,1,1,pass
10462,1,True,511,0,511,4,1,pass
10463,1,True,150,32,182,11,2,pass
10464,1,True,15,37,52,2,1,pass
10465,1,True,4,0,4,1,1,pass
10466,1,True,5,1,6,1,1,pass
10467,1,True,52,63,115,2,1,pass
10468,1,True,3,0,3,1,1,pass
10469,1,True,21,16,37,2,1,pass
10470,1,True,4,6,10,2,1,pass
10471,1,True,23,23,46,1,1,pass
10472,1,True,5,1,6,2,2,pass
10473,1,True,1,1,2,1,1,pass
10474,1,True,0,55,55,1,1,pass
10475,1,True,8,3,11,1,1,pass
10476,1,True,1,1,2,1,1,pass
10477,1,True,0,10,10,1,1,pass
10478,1,True,0,8,8,1,1,pass
10479,1,True,3,0,3,1,1,pass
10480,1,True,11,1,12,1,1,pass
10481,1,True,4,2,6,1,1,pass
10482,1,True,29,16,45,2,1,pass
10483,1,True,98,19,117,7,4,pass
10487,1,True,1,1,2,1,1,pass
10488,1,True,2,1,3,1,1,pass
10490,2,True,1,1,2,1,1,pass
10491,1,True,11,4,15,1,1,pass
10492,1,True,881,14,895,11,3,pass
10494,1,True,2,2,4,1,1,pass
10495,1,True,57,50,107,1,1,pass
10497,1,True,8,8,16,1,1,pass
10499,1,True,1,1,2,1,1,pass
10502,1,True,2,2,4,1,1,pass
10504,1,True,24,24,48,2,1,pass
10507,1,True,1,1,2,1,1,pass
10509,1,True,1,1,2,1,1,fail
10510,1,True,1,2,3,1,1,pass
10511,2,True,1211,5,1216,4,2,pass
10512,1,True,868,0,868,1,1,pass
10513,1,True,1,1,2,1,1,pass
10515,1,True,1162,0,1162,1,1,fail
10516,1,True,49,5,54,3,1,pass
10525,1,True,1,1,2,1,1,pass
10529,1,True,1,1,2,1,1,pass
10531,1,True,10,10,20,1,1,pass
10532,2,True,17,15,32,1,1,pass
10533,1,True,17,15,32,1,1,pass
10534,1,True,2,2,4,1,1,pass
10541,1,True,1,1,2,1,1,pass
10542,1,True,1,1,2,1,1,pass
10545,1,True,660,403,1063,16,4,pass
10549,1,True,189,22,211,2,1,pass
10551,1,True,10,1,11,8,1,pass
10552,1,True,1,1,2,1,1,fail
10554,1,True,1,1,2,1,1,pass
10555,1,True,2,2,4,1,1,pass
10556,1,True,3,3,6,3,1,pass
10557,1,True,3,3,6,3,1,pass
10558,1,True,3,3,6,3,1,pass
10559,1,True,5,5,10,3,1,pass
10560,1,True,3,1,4,1,1,pass
10562,1,True,1,1,2,1,1,pass
10565,1,True,3,0,3,1,1,pass
10572,1,True,1,1,2,1,1,pass
10573,1,True,1887,0,1887,9,3,pass
10574,2,True,996196,26557,1022753,300,37,pass
10575,2,True,167,0,167,2,1,fail
10576,1,True,1,1,2,3,1,pass
10578,1,True,8,3,11,2,1,pass
10581,1,True,4,0,4,1,1,pass
10583,1,True,3,0,3,1,1,pass
10584,1,True,1,1,2,1,1,pass
10585,1,True,1,1,2,1,1,pass
10586,1,True,162,0,162,3,1,pass
10588,1,True,11,4,15,1,1,pass
10589,1,True,1,1,2,1,1,pass
10592,1,True,1,1,2,1,1,pass
10593,1,True,3,2,5,1,1,pass
10594,1,True,1,1,2,1,1,pass
10595,1,True,1,1,2,1,1,pass
10596,1,True,4,6,10,2,1,pass
10597,1,True,2,2,4,1,1,pass
10598,1,True,14,14,28,9,1,pass
10599,1,True,9,9,18,1,1,pass
10602,1,True,1,1,2,1,1,fail
10603,1,True,27,9,36,1,1,fail
10606,1,True,0,6,6,2,1,pass
10610,1,True,0,90,90,2,1,pass
10611,1,True,50,0,50,2,1,pass
10612,1,True,60,0,60,2,1,pass
10616,1,True,86,7,93,1,1,pass
10618,1,True,56,0,56,1,1,pass
10619,1,True,1,1,2,1,1,pass
10621,1,True,245,0,245,1,1,pass
10628,1,True,1,1,2,1,1,pass
10629,1,True,4,4,8,4,1,pass
10635,1,True,0,1,1,1,1,pass
10637,1,True,2,1,3,1,1,pass
10640,1,True,9,3,12,1,1,pass
10641,1,True,1,1,2,1,1,pass
10642,1,True,1,0,1,1,1,pass
10644,1,True,2,2,4,1,1,pass
10645,1,True,1,1,2,1,1,pass
10646,1,True,130,1,131,4,2,pass
10647,1,True,11,7,18,1,1,pass
10648,1,True,37,10,47,2,1,pass
10649,1,True,39,44,83,3,2,pass
10652,1,True,8,8,16,2,1,pass
10654,1,True,22,20,42,2,1,pass
10656,1,True,44,46,90,3,1,pass
10658,1,True,12,2,14,2,1,pass
10659,1,True,9,30,39,2,1,pass
10660,1,True,6999,0,6999,46,8,pass
10661,1,True,28,6,34,24,1,pass
10664,1,True,1,1,2,1,1,pass
10665,1,True,1,1,2,1,1,pass
10667,1,True,2,3,5,3,2,pass
10668,1,True,246,11,257,3,1,pass
10669,1,True,8,4,12,1,1,pass
10670,1,True,3,6,9,1,1,pass
10671,1,True,132,18,150,4,1,pass
10672,1,True,1,1,2,1,1,pass
10673,1,True,3,1,4,1,1,pass
10674,1,True,2,1,3,1,1,pass
10678,1,True,1,1,2,1,1,pass
10680,1,True,18,26,44,1,1,pass
10682,1,True,2,1,3,1,1,pass
10683,2,True,0,131,131,2,1,pass
10684,1,True,35,0,35,2,2,pass
10685,1,True,0,131,131,2,1,pass
10689,1,True,1,1,2,1,1,pass
10690,1,True,3,1,4,1,1,pass
10691,1,True,12842,10,12852,106,24,pass
10695,1,True,1,2,3,1,1,pass
10696,1,True,8,7,15,2,2,pass
10699,1,True,8733,0,8733,45,3,pass
10701,1,True,1043,3184,4227,91,22,pass
10704,1,True,5,5,10,1,1,pass
10705,1,True,9,7,16,2,2,pass
10706,1,True,498,26,524,5,3,pass
10708,1,True,1,1,2,1,1,pass
10709,1,True,1,0,1,1,1,pass
10710,1,True,0,1,1,1,1,pass
10712,1,True,1,0,1,1,1,fail
10713,1,True,6,6,12,1,1,pass
10716,1,True,10,1074,1084,6,3,pass
10717,1,True,6,5,11,1,1,pass
10720,1,True,5,5,10,1,1,fail
10722,1,True,16,169,185,9,4,fail
10724,1,True,1,1,2,1,1,pass
10725,1,True,1,1,2,1,1,pass
10726,1,True,9,9,18,5,1,fail
10727,1,True,5,5,10,3,1,fail
10728,1,True,0,0,0,1,1,fail
10731,1,True,1,1,2,1,1,fail
10733,1,True,4,4,8,1,1,pass
10734,1,True,1,1,2,1,1,fail
10735,1,True,19,15,34,7,3,pass
10736,1,True,1,1,2,1,1,pass
10737,1,True,25,17,42,3,1,pass
10738,1,True,27,3,30,1,1,pass
10739,1,True,3,4,7,1,1,pass
10740,1,True,3,7,10,1,1,pass
10741,1,True,12,19,31,2,1,pass
10742,1,True,15,13,28,8,2,pass
10744,1,True,1,0,1,1,1,fail
10745,1,True,6,0,6,1,1,fail
10746,1,True,1,1,2,1,1,fail
10747,1,True,2,2,4,1,1,fail
10748,1,True,0,2,2,1,1,fail
10749,1,True,301,2,303,4,2,pass
10752,2,True,641,458,1099,37,3,pass
10753,1,True,27,7,34,1,1,pass
10754,1,True,17,7,24,1,1,pass
10755,1,True,18,1,19,6,1,pass
10756,1,True,66,58,124,3,2,pass
10757,1,True,4,5,9,4,1,pass
10758,1,True,1,0,1,1,1,pass
10759,1,True,21,6,27,4,2,pass
10760,1,True,25,38,63,4,2,pass
10761,1,True,23,7,30,2,1,pass
10763,1,True,2,2,4,1,1,pass
10765,1,True,2,3,5,1,1,pass
10766,1,True,6,0,6,1,1,pass
10767,1,True,62,57,119,9,1,fail
10768,1,True,702,352,1054,12,3,fail
10771,1,True,4899,680,5579,91,12,pass
10774,2,True,0,0,0,0,0,fail
10775,2,True,63,28,91,7,3,pass
10776,1,True,2,1,3,1,1,pass
10779,1,True,2,2,4,1,1,pass
10782,1,True,2,2,4,2,1,fail
10783,1,True,2,4,6,2,1,fail
10784,1,True,50,7,57,4,1,fail
10785,1,True,8,8,16,2,1,fail
10787,1,True,1,0,1,1,1,fail
10790,1,True,1,1,2,1,1,fail
10791,1,True,2,0,2,1,1,fail
10793,1,True,4,4,8,1,1,pass
10795,1,True,1,1,2,1,1,fail
10797,1,True,38,3,41,1,1,fail
10798,1,True,3,1,4,1,1,fail
10800,1,True,5,9,14,3,2,fail
10802,1,True,1,1,2,1,1,pass
10809,1,True,1,1,2,1,1,fail
10811,1,True,5,5,10,1,1,pass
10812,1,True,2,4,6,2,1,fail
10814,1,True,1,1,2,1,1,pass
10816,1,True,1,1,2,1,1,pass
10817,1,True,9,12,21,1,1,pass
10818,1,True,13,10,23,2,1,pass
10820,1,True,29,20,49,3,1,pass
10821,1,True,5,3,8,1,1,fail
10822,1,True,52,23,75,3,1,pass
10823,1,True,6,6,12,3,1,fail
10824,1,True,70,14,84,14,2,pass
10825,2,True,725,586,1311,23,3,pass
10826,1,True,2,1,3,1,1,pass
10827,2,True,518,455,973,5,1,pass
10828,2,True,528,464,992,13,2,pass
10830,1,True,6,6,12,1,1,fail
10831,1,True,1,1,2,1,1,pass
10832,2,True,12,13,25,4,1,pass
10834,2,True,8,8,16,6,2,fail
10835,1,True,13609,2594,16203,177,25,pass
10836,1,True,1,1,2,1,1,fail
10837,1,True,11,12,23,4,1,pass
10839,1,True,5,5,10,5,1,fail
10841,2,True,1,0,1,1,1,fail
10843,2,True,12,11,23,4,1,fail
10845,1,True,12,11,23,4,1,fail
10846,2,True,3,1,4,1,1,pass
10847,1,True,3,3,6,1,1,pass
10849,1,True,1,1,2,1,1,pass
10851,2,True,60,58,118,1,1,fail
10853,2,True,11,12,23,4,1,pass
10854,2,True,11,12,23,4,1,pass
10856,2,True,109,42,151,4,3,fail
10857,2,True,3226,382,3608,153,9,pass
10858,2,True,109,42,151,4,3,pass
10860,1,True,11,9,20,3,1,pass
10863,2,True,3,0,3,3,1,pass
10865,2,True,1,0,1,1,1,fail
10867,2,True,26289,1080,27369,300,20,pass
10868,2,True,26289,1080,27369,300,20,pass
10869,1,True,5,4,9,1,1,pass
10872,2,True,3261,347,3608,147,9,pass
10874,2,True,5,5,10,4,1,pass
10876,2,True,4,4,8,3,1,pass
10878,2,True,36,95,131,2,1,fail
10879,2,True,36,95,131,2,1,fail
10880,2,True,53,95,148,3,2,pass
10882,1,True,36,95,131,2,1,pass
10883,2,True,17,0,17,1,1,pass
10884,1,True,1,1,2,1,1,pass
10885,1,True,4,4,8,3,1,pass
10887,1,True,1,1,2,1,1,fail
10888,1,True,1,0,1,1,1,fail
10889,1,True,1,1,2,1,1,fail
10891,1,True,4,0,4,2,1,pass
10892,1,True,219,192,411,28,1,pass
10894,1,True,17,0,17,1,1,pass
10895,1,True,1,6,7,1,1,pass
10896,1,True,12,5,17,4,1,pass
10898,1,True,3,3,6,1,1,fail
10903,1,True,82,22,104,74,1,pass
10907,1,True,11,1,12,1,1,pass
10909,1,True,3,0,3,1,1,pass
10911,1,True,4,3,7,2,1,pass
10913,1,True,1,0,1,1,1,pass
10915,1,True,22,0,22,3,2,fail
10916,1,True,0,0,0,22,8,pass
10919,1,True,1,1,2,1,1,fail
10920,1,True,0,2,2,1,1,fail
10921,1,True,182,96,278,7,2,pass
10923,1,True,2539,0,2539,22,8,pass
10925,1,True,3,3,6,2,1,pass
10926,1,True,60,58,118,1,1,pass
10927,1,True,2,2,4,1,1,pass
10930,1,True,2,3,5,1,1,fail
10933,1,True,1,1,2,1,1,pass
10934,1,True,2,0,2,1,1,pass
10935,1,True,2,2,4,1,1,pass
10936,1,True,1,1,2,1,1,pass
10937,1,True,1,1,2,1,1,pass
10940,1,True,8,8,16,2,2,pass
10942,1,True,11177,0,11177,42,7,pass
10944,1,True,9,1,10,2,1,pass
10945,1,True,1,1,2,1,1,pass
10946,1,True,142,2,144,2,1,pass
10948,2,True,16775,582,17357,157,19,pass
10949,1,True,3,2,5,1,1,pass
10950,1,True,184,88,272,35,2,pass
10952,1,True,41,58,99,4,1,pass
10953,1,True,1,1,2,1,1,pass
10956,1,True,7,4,11,1,1,pass
10957,1,True,1,1,2,1,1,pass
10959,1,True,8,8,16,1,1,pass
10960,1,True,1,1,2,1,1,pass
10961,1,True,118,17,135,2,1,pass
10964,1,True,1,1,2,1,1,pass
10965,1,True,2,2,4,1,1,pass
10966,1,True,2,2,4,1,1,pass
10967,1,True,3,3,6,1,1,pass
10968,1,True,1,0,1,1,1,pass
10972,1,True,3,1,4,1,1,pass
10973,1,True,1,1,2,1,1,pass
10974,1,True,4,1,5,1,1,pass
10976,1,True,32,39,71,1,1,pass
10978,1,True,35,0,35,1,1,pass
10979,1,True,1,1,2,1,1,pass
10981,1,True,2,2,4,1,1,pass
10982,1,True,5,6,11,1,1,pass
10983,1,True,1,1,2,1,1,pass
10984,1,True,42,55,97,2,2,pass
10986,1,True,1,0,1,1,1,pass
10988,1,True,0,0,0,1,1,pass
10989,1,True,1,4,5,1,1,pass
10990,1,True,2,5,7,1,1,pass
10991,1,True,2,4,6,1,1,pass
10992,1,True,176,152,328,3,2,pass
10993,1,True,249,0,249,1,1,pass
10996,1,True,43,43,86,1,1,pass
11000,1,True,3,2,5,1,1,pass
11003,1,True,4,1,5,1,1,pass
11004,1,True,3,0,3,1,1,pass
11006,1,True,2,2,4,1,1,pass
11011,1,True,1,1,2,1,1,pass
11012,1,True,61,185,246,3,2,pass
11014,1,True,0,226,226,2,2,pass
11015,1,True,6960,0,6960,41,9,pass
11017,1,True,1,1,2,1,1,pass
11018,1,True,4,4,8,1,1,pass
11020,1,True,633,0,633,4,3,pass
11021,1,True,1,1,2,1,1,pass
11023,2,True,13,11,24,8,4,pass
11024,1,True,437,2,439,6,2,pass
11025,1,True,1,1,2,1,1,pass
11026,1,True,1999,0,1999,15,4,pass
11028,1,True,1,1,2,1,1,pass
11032,1,True,2,1,3,1,1,pass
11033,1,True,1,1,2,1,1,pass
11034,1,True,1,1,2,1,1,pass
11036,1,True,3,1,4,1,1,pass
11038,1,True,1,1,2,1,1,pass
11041,1,True,983,74,1057,18,6,pass
11044,1,True,2,2,4,2,1,pass
11045,1,True,27,3,30,2,1,pass
11046,1,True,2,2,4,1,1,pass
11047,2,True,1,0,1,1,1,pass
11048,1,True,1,1,2,1,1,pass
11049,1,True,21,42,63,1,1,pass
11051,1,True,1,0,1,1,1,pass
11053,1,True,0,0,0,8,1,pass
11054,1,True,2,2,4,1,1,pass
11055,1,True,6,8,14,1,1,pass
11057,1,True,7,5,12,1,1,pass
11059,1,True,1,1,2,1,1,pass
11060,1,True,1,0,1,1,1,pass
11061,1,True,1,0,1,1,1,pass
11062,1,True,1,0,1,1,1,pass
11064,1,True,4,4,8,1,1,fail
11066,1,True,1,1,2,1,1,fail
11068,1,True,0,1,1,1,1,fail
11070,1,True,1,0,1,1,1,fail
11071,1,True,8,4,12,1,1,pass
11073,1,True,1,0,1,1,1,pass
11074,1,True,5181,0,5181,35,7,pass
11076,1,True,1,1,2,1,1,pass
11077,1,True,1,0,1,1,1,pass
11078,1,True,2,0,2,1,1,pass
11079,1,True,1,0,1,1,1,pass
11080,1,True,0,3,3,2,1,pass
11084,1,True,3,3,6,2,2,pass
11086,1,True,17,15,32,7,2,pass
11088,1,True,16,6,22,3,1,pass
11089,1,True,146,0,146,1,1,pass
11090,1,True,816,0,816,12,5,pass
11094,1,True,611,69,680,8,4,pass
11095,1,True,453,0,453,4,2,pass
11096,1,True,627,0,627,5,2,pass
11102,1,True,9,8,17,7,1,pass
11103,1,True,2,0,2,1,1,pass
11107,1,True,5,3,8,1,1,pass
11113,1,True,1,1,2,1,1,pass
11115,1,True,51,19,70,2,1,pass
11118,1,True,523,47,570,6,3,pass
11123,1,True,1,1,2,1,1,pass
11126,1,True,2,2,4,1,1,pass
11127,1,True,1,1,2,1,1,pass
11130,1,True,5,2,7,1,1,pass
11131,1,True,85,6,91,2,1,pass
11132,1,True,172,93,265,2,1,pass
11135,1,True,38,7,45,2,1,pass
11137,1,True,1,1,2,1,1,pass
11138,1,True,9,6,15,1,1,pass
11139,1,True,18,3,21,2,2,pass
11140,1,True,2,1,3,1,1,pass
11141,1,True,10,8,18,3,1,pass
11142,1,True,19,24,43,1,1,fail
11143,1,True,16,10,26,2,1,pass
11144,1,True,19,21,40,3,1,fail
11145,1,True,2,0,2,1,1,pass
11146,1,True,16,18,34,4,1,pass
11149,1,True,9,14,23,1,1,pass
11152,1,True,3,3,6,2,1,pass
11154,1,True,4,60,64,2,1,pass
11157,1,True,3,3,6,1,1,pass
11160,1,True,59,44,103,2,1,pass
11163,1,True,10,8,18,1,1,pass
11166,1,True,1,1,2,1,1,pass
11168,1,True,0,8,8,1,1,pass
11169,1,True,1,0,1,1,1,pass
11170,1,True,0,2,2,1,1,pass
11171,1,True,5,3,8,2,2,pass
11175,1,True,1,0,1,1,1,pass
11176,1,True,0,2,2,1,1,fail
11178,1,True,208,50,258,3,2,pass
11180,1,True,1,1,2,1,1,pass
11181,1,True,185,20,205,4,2,pass
11183,1,True,501,0,501,5,2,pass
11184,1,True,1419,102,1521,21,3,pass
11185,1,True,0,2,2,1,1,pass
11188,1,True,2,1,3,1,1,pass
11190,1,True,0,2,2,1,1,pass
11191,1,True,1027,264,1291,12,2,pass
11192,1,True,3766,226,3992,54,4,pass
11194,1,True,196,40,236,3,1,pass
11196,1,True,0,1,1,1,1,pass
11197,1,True,318,355,673,4,2,pass
11199,1,True,84,84,168,4,2,pass
11201,1,True,6,85,91,2,1,pass
11207,1,True,592,39,631,19,2,pass
11209,1,True,251,24,275,15,2,pass
11210,1,True,2135,327,2462,14,2,pass
11211,1,True,0,2,2,1,1,pass
11212,1,True,2274,132,2406,17,2,pass
11213,1,True,2734,0,2734,2,1,pass
11214,1,True,2,2,4,1,1,pass
11215,1,True,5,5,10,1,1,pass
11216,1,True,4,4,8,1,1,pass
11220,1,True,1,1,2,1,1,pass
11222,1,True,25,0,25,2,1,pass
11225,1,True,2232,36,2268,24,7,pass
11227,1,True,1,0,1,1,1,pass
11228,1,True,6,7,13,4,2,pass
11233,1,True,1,1,2,1,1,pass
11234,1,True,1,1,2,1,1,pass
11235,1,True,1,1,2,1,1,pass
11239,1,True,6,5,11,2,2,pass
11241,1,True,1,1,2,1,1,pass
11244,1,True,1,1,2,1,1,pass
11246,1,True,1,1,2,1,1,pass
11256,1,True,3,2,5,1,1,pass
11259,1,True,2,1,3,1,1,pass
11260,1,True,0,1,1,1,1,pass
11261,1,True,37,37,74,8,3,fail
11262,1,True,38,37,75,8,1,pass
11263,1,True,36,17,53,4,1,pass
11264,1,True,2,3,5,3,1,pass
11265,1,True,0,2,2,1,1,pass
11266,1,True,5,1,6,1,1,pass
11267,1,True,16,17,33,2,1,pass
11268,1,True,10,10,20,1,1,pass
11269,1,True,14,13,27,1,1,pass
11277,1,True,1,1,2,1,1,pass
11286,1,True,3,4,7,1,1,pass
11287,1,True,2,5,7,1,1,pass
11288,1,True,1,1,2,1,1,pass
11289,1,True,2,2,4,1,1,pass
11292,1,True,21,21,42,3,1,pass
11293,1,True,3,0,3,1,1,pass
11297,1,True,4,3,7,1,1,pass
11299,1,True,5576,0,5576,21,7,pass
11301,1,True,1,1,2,1,1,pass
11302,1,True,23,22,45,1,1,pass
11304,1,True,1112,0,1112,7,1,pass
11307,1,True,1,1,2,1,1,pass
11310,1,True,13,11,24,1,1,pass
11311,1,True,2,2,4,1,1,pass
11312,1,True,1,1,2,1,1,pass
11315,1,True,0,1,1,1,1,pass
11316,1,True,15,10,25,5,4,pass
11318,1,True,1,1,2,1,1,pass
11319,1,True,1,1,2,1,1,pass
11320,1,True,3,3,6,1,1,pass
11323,2,True,0,0,0,0,0,pass
11324,1,True,20,21,41,1,1,pass
11325,1,True,1,1,2,1,1,pass
11327,2,True,74,50,124,2,2,pass
11328,2,True,996,64,1060,23,8,pass
11330,1,True,0,1,1,1,1,pass
11331,1,True,15,16,31,1,1,pass
11332,1,True,63,37,100,1,1,pass
11333,2,True,1004,68,1072,23,8,pass
11334,2,True,31,28,59,2,1,pass
11336,1,True,2,2,4,1,1,pass
11337,2,True,973,40,1013,21,8,pass
11339,1,True,19,16,35,1,1,pass
11340,1,True,6,6,12,1,1,pass
11341,1,True,894,0,894,5,3,pass
11342,1,True,13,12,25,2,1,pass
11345,1,True,2,9,11,3,3,pass
11347,1,True,1,1,2,1,1,pass
11348,1,True,6,6,12,1,1,pass
11349,1,True,5,5,10,1,1,pass
11350,1,True,6,6,12,1,1,pass
11351,1,True,4,4,8,1,1,pass
11353,1,True,105,119,224,2,1,pass
11354,1,True,30,50,80,2,2,pass
11355,1,True,25,15,40,2,1,pass
11357,2,True,40,2,42,2,1,pass
11358,1,True,5,1,6,1,1,pass
11359,1,True,40,2,42,2,1,pass
11360,1,True,2,2,4,1,1,pass
11361,1,True,2,2,4,1,1,pass
11362,1,True,3,2,5,1,1,pass
11363,1,True,3,3,6,1,1,pass
11364,1,True,15,7,22,1,1,pass
11365,1,True,15,7,22,1,1,pass
11366,1,True,15,8,23,1,1,pass
11367,1,True,2,2,4,1,1,pass
11368,1,True,9,6,15,1,1,pass
11369,2,True,118,115,233,2,2,pass
11370,1,True,72,58,130,1,1,pass
11371,1,True,46,57,103,1,1,pass
11373,1,True,6,3,9,1,1,pass
11374,2,True,624,483,1107,8,3,pass
11377,1,True,162,178,340,4,2,pass
11379,1,True,83,41,124,4,2,pass
11380,1,True,430,347,777,4,2,pass
11384,1,True,11,0,11,1,1,pass
11385,1,True,1,1,2,1,1,pass
11389,1,True,131,28,159,5,2,pass
11391,1,True,3,1,4,1,1,pass
11393,1,True,2,2,4,1,1,pass
11394,2,True,18691,1199,19890,187,22,pass
11395,1,True,19,4,23,1,1,pass
11396,1,True,40,0,40,3,3,pass
11397,2,True,18691,1199,19890,187,22,pass
11398,1,True,147,28,175,3,1,pass
11400,1,True,1270,0,1270,11,3,pass
11401,1,True,9,6,15,1,1,pass
11402,1,True,4,3,7,2,1,pass
11403,1,True,15,17,32,1,1,pass
11405,1,True,1464,3,1467,13,2,pass
11408,1,True,1,2,3,1,1,pass
11409,1,True,6,0,6,1,1,pass
11410,1,True,0,3,3,1,1,pass
11411,1,True,6,1,7,1,1,pass
11413,1,True,77,0,77,1,1,pass
11415,1,True,0,42,42,1,1,pass
11417,1,True,2,2,4,1,1,pass
11418,1,True,31,34,65,1,1,pass
11420,1,True,7,1,8,1,1,pass
11421,1,True,3,3,6,1,1,pass
11422,1,True,1,1,2,1,1,pass
11423,1,True,10,11,21,1,1,pass
11425,1,True,1,3,4,1,1,pass
11426,1,True,1,3,4,1,1,pass
11427,1,True,2,1,3,1,1,pass
11428,1,True,1,2,3,1,1,pass
11429,1,True,1,2,3,1,1,pass
11430,1,True,2,2,4,1,1,pass
11431,1,True,6,4,10,1,1,pass
11432,1,True,0,2,2,1,1,pass
11434,1,True,7,7,14,1,1,pass
11436,1,True,1,2,3,1,1,pass
11437,1,True,25,21,46,1,1,pass
11438,1,True,5,10,15,1,1,pass
11439,1,True,153,46,199,5,1,pass
11440,1,True,2,2,4,1,1,pass
11441,1,True,41,0,41,1,1,pass
11442,1,True,1,1,2,1,1,pass
11443,1,True,19,1,20,1,1,pass
11444,1,True,22,11,33,1,1,pass
11445,1,True,1,0,1,1,1,pass
11446,1,True,392,14,406,1,1,pass
11447,1,True,21,18,39,1,1,pass
11450,1,True,56,0,56,7,1,pass
11451,1,True,26,14,40,1,1,pass
11452,1,True,13,15,28,1,1,pass
11453,1,True,3,2,5,1,1,pass
11454,2,True,10874,1116,11990,136,21,pass
11455,1,True,24,16,40,1,1,pass
11456,1,True,69,35,104,1,1,pass
11457,1,True,90,0,90,1,1,pass
11458,1,True,104,24,128,1,1,pass
11460,1,True,17,15,32,6,1,pass
11463,1,True,11,0,11,1,1,pass
11464,1,True,3,1,4,2,1,pass
11470,1,True,0,1,1,1,1,pass
11471,1,True,10,4,14,2,1,pass
11472,1,True,1,1,2,1,1,pass
11474,1,True,19,13,32,1,1,pass
11475,2,True,61497,649,62146,300,31,pass
11476,1,True,1,1,2,1,1,pass
11477,1,True,1,1,2,1,1,pass
11480,1,True,3,3,6,1,1,pass
11481,1,True,1,1,2,1,1,pass
11482,1,True,1,0,1,1,1,pass
11483,1,True,1798,0,1798,9,3,pass
11484,1,True,1,1,2,1,1,pass
11485,1,True,1,1,2,1,1,pass
11486,1,True,1,1,2,1,1,pass
11487,1,True,130,107,237,1,1,pass
11488,1,True,72,98,170,1,1,pass
11491,1,True,2,3,5,1,1,pass
11492,1,True,150,58,208,6,3,pass
11495,1,True,1,1,2,1,1,pass
11496,1,True,3517,20,3537,20,5,pass
11498,1,True,0,1,1,1,1,pass
11499,1,True,1,1,2,1,1,pass
11500,1,True,33,19,52,1,1,pass
11501,1,True,1,0,1,1,1,pass
11502,1,True,7,11,18,1,1,pass
11503,1,True,3018,0,3018,24,6,pass
11505,1,True,1,1,2,1,1,pass
11506,1,True,1,3,4,1,1,pass
11507,2,True,2,5,7,2,2,pass
11508,1,True,9,5,14,1,1,pass
11509,1,True,8,6,14,2,1,pass
11512,1,True,1,1,2,1,1,pass
11513,1,True,160,73,233,3,1,pass
11514,1,True,297,245,542,3,1,pass
11515,1,True,95,36,131,5,3,pass
11516,1,True,309,156,465,7,3,pass
11517,1,True,144,176,320,4,1,pass
11518,1,True,236,67,303,2,1,pass
11519,1,True,117,97,214,2,1,pass
11520,1,True,5,4,9,1,1,pass
11521,1,True,76,100,176,11,3,pass
11522,1,True,1,4,5,1,1,pass
11527,1,True,9,1,10,1,1,pass
11528,1,True,4,4,8,1,1,pass
11529,1,True,1,1,2,1,1,pass
11530,1,True,247,45,292,7,4,pass
11531,1,True,1,1,2,1,1,pass
11532,1,True,8,8,16,1,1,pass
11533,1,True,11,0,11,1,1,pass
11536,1,True,1,1,2,1,1,pass
11538,1,True,2,2,4,1,1,pass
11539,1,True,1,2,3,1,1,pass
11540,1,True,1,1,2,1,1,pass
11548,1,True,1,1,2,1,1,pass
11550,1,True,14,8,22,1,1,pass
11551,1,True,3,3,6,1,1,pass
11552,1,True,33,0,33,1,1,pass
11553,1,True,1,1,2,1,1,pass
11554,1,True,1,1,2,1,1,pass
11555,1,True,24,17,41,1,1,pass
11557,1,True,1,1,2,1,1,pass
11558,1,True,59,20,79,6,1,pass
11560,1,True,106,87,193,3,2,pass
11563,1,True,1,10,11,3,2,pass
11567,1,True,97,2,99,3,1,pass
11569,1,True,20,14,34,1,1,pass
11571,1,True,206,2,208,5,3,pass
11572,1,True,1,1,2,1,1,pass
11573,1,True,6,4,10,1,1,pass
11574,1,True,33,24,57,1,1,pass
11575,1,True,42,21,63,1,1,pass
11577,1,True,10,9,19,1,1,pass
11579,1,True,1,1,2,1,1,pass
11580,1,True,1,2,3,1,1,pass
11581,1,True,3,3,6,2,1,pass
11582,1,True,3,0,3,1,1,pass
11583,1,True,16,15,31,3,2,pass
11585,1,True,2,2,4,1,1,pass
11586,1,True,1,1,2,1,1,pass
11587,2,True,51470,609,52079,300,28,pass
11588,1,True,121,4,125,3,2,pass
11589,1,True,3370,0,3370,14,2,pass
11590,1,True,1,1,2,1,1,pass
11592,1,True,1,1,2,1,1,pass
11593,1,True,3,3,6,1,1,pass
11594,1,True,1,1,2,1,1,pass
11595,1,True,1,2,3,1,1,pass
11600,1,True,3,1,4,1,1,pass
11601,1,True,2,2,4,1,1,pass
11602,1,True,1,1,2,1,1,pass
11603,1,True,16,12,28,1,1,pass
11604,2,True,69321,1108,70429,300,28,pass
11606,1,True,849,0,849,5,2,pass
11609,1,True,1,0,1,1,1,pass
11612,1,True,1,1,2,1,1,pass
11613,2,True,5730,253,5983,59,9,pass
11614,1,True,2,0,2,1,1,pass
11615,1,True,3,1,4,1,1,pass
11616,1,True,2,0,2,1,1,pass
11617,1,True,2,0,2,1,1,pass
11618,1,True,2,0,2,1,1,pass
11619,1,True,2,0,2,1,1,pass
11620,1,True,2,0,2,1,1,pass
11621,1,True,2,0,2,1,1,pass
11622,1,True,1,1,2,1,1,pass
11624,1,True,6,4,10,4,1,pass
11625,2,True,33,33,66,2,1,pass
11626,1,True,142,7,149,4,2,pass
11628,1,True,1,1,2,1,1,pass
11632,1,True,169,38,207,3,1,pass
11635,1,True,13,14,27,5,1,pass
11637,1,True,1,1,2,1,1,pass
11638,2,True,1,1,2,1,1,pass
11639,1,True,193,32,225,3,1,pass
11640,1,True,194,33,227,3,1,pass
11641,2,True,0,0,0,0,0,pass
11643,1,True,11,11,22,1,1,pass
11644,1,True,12,12,24,1,1,pass
11645,1,False,0,1,1,1,1,pass
11646,1,True,2,2,4,1,1,pass
11647,1,True,8,8,16,1,1,pass
11648,1,True,1,1,2,1,1,pass
11649,1,True,5,3,8,1,1,pass
11650,1,True,3,1,4,1,1,pass
11651,1,True,1,1,2,1,1,pass
11654,1,True,1,1,2,1,1,pass
11655,1,True,3,3,6,1,1,pass
11659,1,True,1,1,2,1,1,pass
11660,1,True,4887,0,4887,15,6,pass
11663,1,True,1,1,2,1,1,pass
11664,1,True,4,4,8,1,1,pass
11674,1,True,3,3,6,1,1,pass
11677,1,True,11,60,71,2,2,pass
11682,1,True,1,1,2,1,1,pass
11684,1,True,0,2,2,1,1,pass
11685,1,True,1,1,2,1,1,pass
11689,1,True,2,0,2,1,1,pass
11691,1,True,1,0,1,1,1,pass
11696,1,True,2,2,4,1,1,pass
11698,1,True,3,2,5,2,1,pass
11699,1,True,2,2,4,2,1,pass
11703,1,True,208,116,324,17,4,pass
11704,1,True,2,2,4,1,1,pass
11705,1,True,10,14,24,1,1,pass
11706,1,True,2,1,3,1,1,fail
11708,1,True,2,1,3,1,1,fail
11709,1,True,12,9,21,3,1,fail
11711,1,True,1,1,2,1,1,fail
11712,1,True,1,0,1,1,1,fail
11715,1,True,5,1,6,1,1,pass
11717,1,True,1,1,2,1,1,pass
11719,1,True,2,2,4,1,1,pass
11722,1,True,2,4,6,1,1,pass
11723,1,True,6,2,8,2,1,pass
11724,1,True,3,6,9,2,1,pass
11725,1,True,2,0,2,1,1,pass
11726,1,True,13,5,18,2,1,pass
11727,2,True,634934,2210,637144,300,27,pass
11728,1,True,21,4,25,1,1,fail
11730,1,True,5,5,10,1,1,pass
11731,1,True,5,5,10,1,1,pass
11733,1,True,1,1,2,1,1,pass
11735,1,True,1,1,2,1,1,pass
11737,1,True,0,0,0,2,1,pass
11739,1,True,0,1,1,1,1,pass
11742,1,True,2,2,4,1,1,pass
11743,1,True,32,16,48,3,1,pass
11745,1,True,12,5,17,4,2,pass
11747,1,True,1,1,2,1,1,pass
11749,1,True,6,6,12,1,1,pass
11752,1,True,6,12,18,3,1,pass
11753,1,True,93,0,93,1,1,pass
11755,1,True,2,4,6,4,1,pass
11757,1,True,3479,0,3479,37,3,pass
11758,1,True,2,2,4,1,1,pass
11759,1,True,1,1,2,1,1,pass
11760,1,True,3,3,6,1,1,pass
11761,1,True,22,27,49,4,1,pass
11764,1,True,2,2,4,1,1,pass
11765,1,True,1,1,2,1,1,pass
11768,1,True,8,10,18,1,1,pass
11769,1,True,20,7,27,1,1,pass
11770,1,True,4,2,6,1,1,pass
11771,1,True,1,3,4,1,1,pass
11773,1,True,3,3,6,2,1,pass
11776,1,True,4,4,8,1,1,pass
11777,1,True,1,1,2,1,1,pass
11779,1,True,0,2,2,1,1,pass
11782,1,True,3,2,5,1,1,pass
11783,1,True,15,5,20,1,1,pass
11786,1,True,2,2,4,1,1,pass
11787,1,True,2,2,4,1,1,pass
11788,1,True,4,3,7,1,1,pass
11790,1,True,17,15,32,2,1,pass
11793,1,True,14,4,18,1,1,pass
11794,1,True,14,4,18,1,1,pass
11798,1,True,3,3,6,3,1,pass
11799,1,True,35,20,55,3,1,pass
11801,1,True,2,3,5,1,1,pass
11803,2,True,439,91,530,13,2,pass
11804,1,True,1,0,1,1,1,pass
11805,1,True,3192,0,3192,23,5,pass
11808,1,True,330,0,330,2,2,pass
11809,1,True,1,1,2,1,1,pass
11811,1,True,3,3,6,1,1,pass
11812,1,True,1,1,2,1,1,pass
11815,1,True,1,1,2,1,1,pass
11818,1,True,78,78,156,5,1,pass
11821,1,True,1340,4,1344,3,3,pass
11829,1,True,3673,0,3673,17,4,pass
11831,1,True,8476,0,8476,51,9,pass
11845,1,True,115,101,216,6,3,pass
11848,1,True,0,0,0,1,1,pass
11849,1,True,34,16,50,2,1,pass
11857,1,True,16,16,32,2,1,pass
11859,1,True,15,0,15,1,1,pass
11863,1,True,15,19,34,2,1,pass
11868,1,True,1,1,2,1,1,pass
11870,1,True,11,66,77,4,2,pass
11871,2,True,149,143,292,20,3,pass
11887,1,True,6,1,7,1,1,pass
11889,2,True,34,68,102,8,2,pass
11890,1,True,0,2,2,1,1,pass
11891,1,True,10,1,11,1,1,pass
11896,1,True,29,31,60,1,1,pass
11897,1,True,11,47,58,1,1,pass
11898,1,True,0,0,0,1,1,pass
11899,1,True,20,18,38,5,1,pass
11900,1,True,3,3,6,2,2,pass
11901,1,True,1,1,2,1,1,pass
11902,2,True,0,0,0,0,0,pass
11903,2,True,0,0,0,0,0,pass
11904,2,True,0,0,0,0,0,pass
11905,2,True,0,0,0,0,0,pass
11906,2,True,0,0,0,0,0,pass
11907,2,True,0,0,0,0,0,pass
11908,2,True,0,0,0,0,0,pass
11909,1,True,1,1,2,1,1,pass
11910,1,True,1,1,2,1,1,pass
11911,1,True,1,1,2,1,1,pass
11912,1,True,1,1,2,1,1,pass
11913,1,True,1,1,2,1,1,pass
11914,1,True,1,1,2,1,1,pass
11915,1,True,56,2,58,1,1,pass
11916,1,True,56,2,58,1,1,pass
11917,2,True,0,0,0,0,0,pass
11918,2,True,0,0,0,0,0,pass
11919,1,True,10,1512,1522,16,7,pass
11920,1,True,10,1512,1522,16,7,pass
11921,1,True,4361,0,4361,35,9,pass
11939,1,True,5,1,6,2,2,pass
11940,1,True,5,1,6,2,2,pass
11941,1,True,4361,0,4361,35,9,pass
11944,1,True,1,4,5,3,3,pass
11952,2,True,7,6,13,4,2,pass
11953,1,True,1,1,2,1,1,pass
11955,1,True,3527,192,3719,115,18,pass
11961,2,True,2917,60,2977,39,7,pass
11975,1,True,6,6,12,1,1,pass
11976,1,True,2,2,4,1,1,pass
11979,2,True,86581,4363,90944,72,52,pass
11980,1,True,1,1,2,1,1,pass
11981,1,True,4,4,8,1,1,pass
11985,1,True,1,1,2,1,1,pass
11986,1,True,86578,4360,90938,71,52,pass
11987,2,True,160,44,204,21,4,pass
11988,1,True,2874,0,2874,23,7,pass
11996,1,True,2,2,4,1,1,pass
11998,1,True,9,3,12,2,2,pass
11999,1,True,5,5,10,3,1,pass
12001,1,True,2,2,4,1,1,pass
12007,1,True,5,5,10,5,1,pass
12008,1,True,102,4,106,3,2,pass
12012,1,True,3,5,8,1,1,pass
12013,1,True,10,11,21,1,1,pass
12016,1,True,7,7,14,1,1,pass
12018,1,True,6,4,10,1,1,pass
12020,1,True,4,1,5,1,1,pass
12022,2,True,0,0,0,0,0,pass
12023,1,True,4362,40,4402,19,17,pass
12025,1,True,76,11,87,2,2,pass
12026,1,True,515602,779,516381,298,64,pass
12032,1,True,2,2,4,2,2,pass
12038,1,True,29,20,49,6,1,pass
12041,1,True,1,1,2,1,1,pass
12043,1,True,1,1,2,1,1,pass
12044,1,True,21,20,41,1,1,pass
12048,1,True,8,92,100,6,1,pass
12049,1,True,8,3,11,1,1,pass
12052,1,True,1,1,2,1,1,pass
12053,1,True,7,12,19,3,1,pass
12054,1,True,1,1,2,1,1,pass
12055,1,True,1,1,2,1,1,pass
12056,1,True,5,5,10,1,1,pass
12057,1,True,15,15,30,2,1,pass
12058,1,True,5,5,10,1,1,pass
12059,1,True,46,46,92,8,1,pass
12060,1,True,314,314,628,71,1,pass
12061,1,True,1,1,2,1,1,pass
12062,1,True,3,2,5,1,1,pass
12063,1,True,3,3,6,2,1,pass
12064,1,True,97,96,193,18,2,pass
12067,1,True,7,7,14,1,1,pass
12069,1,True,5,5,10,1,1,pass
12071,1,True,1,1,2,1,1,pass
12072,1,True,13,6,19,1,1,pass
12073,1,True,8,5,13,1,1,pass
12075,1,True,166,103,269,1,1,pass
12076,1,True,3,2,5,1,1,pass
12079,1,True,5,4,9,1,1,pass
12082,1,True,16,3,19,1,1,pass
12083,1,True,33,36,69,1,1,pass
12084,1,True,12,20,32,1,1,pass
12086,1,True,10,9,19,1,1,pass
12090,1,True,26,53,79,1,1,pass
12092,1,True,1231,0,1231,5,2,pass
12093,1,True,7,1,8,1,1,pass
12094,1,True,6,9,15,2,1,pass
12096,1,True,17,10,27,1,1,pass
12099,1,True,1,1,2,1,1,pass
12100,1,True,4,5,9,2,1,pass
12101,1,True,2,2,4,1,1,pass
12109,1,True,1,0,1,1,1,pass
12110,1,True,1,1,2,1,1,pass
12111,1,True,1,1,2,1,1,pass
12112,1,True,70,70,140,30,2,pass
12113,1,True,6,6,12,1,1,pass
12115,1,True,10,10,20,1,1,pass
12116,1,True,1,1,2,1,1,pass
12117,1,True,1,1,2,1,1,pass
12118,1,True,7,4,11,2,2,pass
12119,1,True,7,4,11,3,2,pass
12120,1,True,2,2,4,1,1,pass
12122,1,True,1,1,2,1,1,pass
12123,1,True,2,2,4,2,1,pass
12124,1,True,1,1,2,1,1,pass
12126,1,True,20,19,39,1,1,pass
12128,1,True,17,20,37,5,1,pass
12129,1,True,1,1,2,1,1,pass
12130,1,True,1,1,2,1,1,pass
12131,1,True,7,7,14,1,1,pass
12133,1,True,1,1,2,1,1,pass
12136,1,True,20,6,26,3,2,pass
12139,1,True,3,11,14,2,1,pass
12140,1,True,16,7,23,2,1,pass
12141,1,True,2615,607,3222,6,2,pass
12143,1,True,14,14,28,3,1,pass
12146,1,True,19,19,38,3,1,pass
12149,1,True,70,73,143,7,2,pass
12150,1,True,15,10,25,2,1,pass
12152,1,True,14,9,23,2,1,pass
12154,1,True,1,1,2,1,1,pass
12156,1,True,2,2,4,1,1,pass
12157,1,True,17,17,34,16,1,pass
12162,1,True,5,3,8,1,1,pass
12168,1,True,3,3,6,1,1,pass
12171,2,True,3684,221,3905,61,6,pass
12175,1,True,4,0,4,1,1,pass
12176,1,True,1,1,2,1,1,pass
12178,1,True,2,2,4,1,1,pass
12180,1,True,1,1,2,1,1,pass
12181,1,True,2689,0,2689,7,2,pass
12183,1,True,3,0,3,1,1,pass
12185,1,True,1,1,2,1,1,pass
12187,1,True,4,4,8,1,1,pass
12188,1,True,11,10,21,3,1,pass
12189,1,True,1,1,2,1,1,pass
12190,1,True,1,1,2,1,1,pass
12191,1,True,12,12,24,4,1,pass
12193,1,True,1,1,2,1,1,pass
12194,1,True,2,2,4,1,1,pass
12196,1,True,3,3,6,2,1,pass
12198,1,True,1,1,2,1,1,pass
12199,1,True,1,1,2,1,1,pass
12200,1,True,1,1,2,1,1,pass
12201,1,True,2,2,4,1,1,pass
12202,1,True,1,1,2,1,1,pass
12203,1,True,1,1,2,1,1,pass
12206,1,True,1,1,2,1,1,pass
12207,1,True,3,0,3,1,1,pass
12209,1,True,1,1,2,1,1,pass
12210,1,True,1,1,2,1,1,pass
12211,1,True,3,3,6,1,1,pass
12212,1,True,96,44,140,3,1,pass
12213,1,True,10,0,10,1,1,pass
12214,1,True,5,5,10,1,1,pass
12216,1,True,1,1,2,1,1,pass
12217,1,True,3,3,6,2,2,pass
12223,1,True,3,3,6,1,1,pass
12228,1,True,1,1,2,1,1,pass
12229,1,True,13,5,18,1,1,pass
12230,1,True,1,1,2,1,1,pass
12233,1,True,885,0,885,11,4,pass
12234,1,True,3,3,6,1,1,pass
12235,1,True,1,1,2,1,1,pass
12236,1,True,5,5,10,1,1,pass
12237,1,True,1,1,2,1,1,pass
12238,1,True,7,7,14,1,1,pass
12240,1,True,4,4,8,1,1,pass
12242,1,True,12,12,24,5,1,pass
12244,1,True,5867,0,5867,45,11,pass
12247,1,True,67,50,117,3,1,pass
12249,1,True,0,1,1,1,1,pass
12250,1,True,10,4,14,2,1,pass
12252,2,True,0,0,0,0,0,pass
12253,1,True,1,1,2,1,1,pass
12254,1,True,2,2,4,1,1,pass
12256,1,True,1,1,2,1,1,pass
12257,1,True,1,1,2,1,1,pass
12258,1,True,3,6,9,1,1,pass
12259,1,True,4,3,7,1,1,pass
12261,1,True,1,0,1,1,1,pass
12262,1,True,18,14,32,1,1,pass
12263,1,True,13,0,13,1,1,pass
12264,1,True,0,0,0,6,1,pass
12265,1,True,0,23,23,1,1,pass
12266,1,True,1,1,2,1,1,pass
12267,1,True,2282,0,2282,7,2,pass
12268,1,True,2,2,4,1,1,pass
12270,1,True,12,5,17,1,1,pass
12272,1,True,3,1,4,1,1,pass
12274,1,True,11,0,11,1,1,pass
12276,1,True,664,100,764,11,3,pass
12277,1,True,1,1,2,1,1,pass
12279,1,True,1,3,4,1,1,pass
12280,1,True,2,2,4,1,1,pass
12282,1,True,1,1,2,1,1,pass
12284,1,True,0,1958,1958,9,2,pass
12286,1,True,0,8,8,1,1,pass
12288,1,True,2586,110,2696,26,9,pass
12290,1,True,26,3,29,1,1,pass
12292,1,True,1,1,2,1,1,pass
12293,1,True,1,1,2,1,1,pass
12294,1,True,17,0,17,1,1,pass
12296,1,True,0,0,0,3,1,pass
12297,1,True,25,0,25,2,1,pass
12299,1,True,6,3,9,1,1,pass
12301,1,True,1,1,2,1,1,pass
12303,1,True,2,1,3,1,1,pass
12306,1,True,9,6,15,3,2,pass
12313,1,True,2208,0,2208,13,5,pass
12315,1,True,2,2,4,1,1,pass
12317,1,True,282,2,284,5,3,pass
12320,1,True,1,1,2,1,1,pass
12322,1,True,7,7,14,5,1,pass
12323,1,True,6,0,6,1,1,pass
12326,1,True,1,1,2,1,1,pass
12327,1,True,1,2,3,1,1,pass
12329,1,True,3,3,6,3,1,pass
12330,1,True,1,1,2,1,1,pass
12331,1,True,4312,0,4312,25,8,pass
12333,1,True,1252,0,1252,7,4,pass
12334,1,True,10,4,14,2,1,pass
12335,2,True,0,0,0,0,0,pass
12336,1,True,1,1,2,1,1,pass
12338,1,True,2,2,4,1,1,pass
12339,1,True,3,2,5,1,1,pass
12341,1,True,5,3,8,3,1,pass
12344,1,True,7,1,8,1,1,pass
12345,1,True,3,0,3,3,1,pass
12347,1,True,1,1,2,1,1,pass
12350,1,True,4,4,8,3,2,pass
12352,1,True,1,2,3,1,1,pass
12354,1,True,16,19,35,5,1,pass
12356,1,True,6,4,10,6,3,pass
12358,1,True,3,3,6,3,1,pass
12359,1,True,4,6,10,6,3,pass
12360,1,True,6,3,9,1,1,pass
12361,1,True,6,4,10,6,3,pass
12362,1,True,3,3,6,3,1,pass
12365,1,True,33,30,63,1,1,pass
12367,1,True,804,0,804,4,3,pass
12368,1,True,1,0,1,1,1,pass
12369,1,True,1,1,2,1,1,pass
12371,1,True,540,0,540,5,3,pass
12373,1,True,16,12,28,1,1,pass
12374,1,True,3399,0,3399,27,10,pass
12376,1,True,67,0,67,2,2,pass
12379,1,True,16,8,24,2,2,pass
12380,1,True,2,1,3,1,1,pass
12381,1,True,2,1,3,1,1,pass
12383,1,True,2,1,3,1,1,pass
12385,1,True,149,184,333,2,2,pass
12387,1,True,8060,818,8878,56,5,pass
12395,1,True,1,4,5,1,1,pass
12396,1,True,5,15,20,1,1,pass
12399,1,True,4,3,7,1,1,pass
12403,1,True,1,1,2,1,1,pass
12410,1,True,1,1,2,1,1,pass
12416,1,True,11657,0,11657,11,5,pass
12418,1,True,2,2,4,1,1,pass
12420,1,True,0,1,1,1,1,pass
12423,1,True,1,1,2,1,1,pass
12424,1,True,1,1,2,1,1,pass
12427,1,True,1,1,2,1,1,pass
12429,1,True,1,1,2,1,1,pass
12432,1,True,0,1,1,1,1,pass
12436,1,True,1,1,2,1,1,pass
12438,1,True,6,6,12,1,1,pass
12439,1,True,1,0,1,1,1,pass
12441,1,True,19,12,31,1,1,pass
12442,1,True,45,1,46,1,1,pass
12443,1,True,5,5,10,1,1,pass
12450,1,True,96,0,96,1,1,pass
12451,1,True,1,1,2,1,1,pass
12453,1,True,197,0,197,1,1,pass
12462,1,True,1,1,2,1,1,pass
12463,1,True,1,1,2,1,1,pass
12464,1,True,1,1,2,1,1,pass
12470,1,True,2,2,4,1,1,pass
12476,1,True,0,11,11,11,1,pass
12477,1,True,320,27,347,11,1,pass
12479,1,True,1,1,2,1,1,pass
12481,2,True,0,0,0,0,0,pass
12482,1,True,181,0,181,1,1,pass
12484,1,True,796,326,1122,12,3,pass
12486,1,True,1,1,2,1,1,pass
12488,1,True,625,0,625,7,3,pass
12490,1,True,1,1,2,1,1,pass
12492,1,True,6,0,6,1,1,pass
12495,1,True,14,14,28,1,1,pass
12496,2,True,1,1,2,1,1,pass
12497,1,True,1,1,2,1,1,pass
12500,1,True,1,1,2,1,1,pass
12501,1,True,1,1,2,1,1,pass
12503,2,True,4,3,7,1,1,pass
12504,1,True,6,12,18,2,1,pass
12506,1,True,3,3,6,1,1,pass
12508,1,True,2,2,4,1,1,pass
12511,1,True,10,0,10,1,1,pass
12512,1,True,480,0,480,12,3,pass
12517,1,True,7,7,14,1,1,pass
12518,1,True,1,1,2,1,1,pass
12520,1,True,1,1,2,1,1,pass
12524,1,True,2,0,2,1,1,pass
12526,1,True,80116,0,80116,41,11,pass
12528,1,True,2431,0,2431,12,5,pass
12545,1,False,1,1,2,1,1,pass
12546,1,False,133,78,211,12,3,pass
12549,1,False,17,14,31,1,1,fail
12550,2,True,6836,3099,9935,161,11,pass
12551,1,True,11,27,38,1,1,fail
12552,1,True,2,1,3,1,1,pass
12553,1,True,6,2,8,2,2,fail
12554,1,True,6,8,14,2,2,fail
12555,1,True,19,25,44,3,3,fail
12556,1,True,27,350,377,6,3,fail
12559,2,True,20,6,26,3,2,pass
12560,1,True,20,6,26,3,2,pass
12561,2,True,35,3,38,3,2,pass
12562,1,True,35,3,38,3,2,pass
12563,1,False,3,2,5,3,2,pass
12564,2,True,17,11,28,3,2,fail
12565,1,True,1,1,2,1,1,pass
12566,1,True,3,3,6,1,1,fail
12567,1,True,1,0,1,1,1,pass
12568,1,True,2,1,3,1,1,fail
12569,1,True,15,11,26,2,2,fail
12570,2,True,3,0,3,2,2,pass
12571,2,True,5,4,9,3,3,pass
12572,2,True,5,4,9,3,3,pass
12574,1,True,5,4,9,3,3,pass
12575,1,False,1,1,2,1,1,pass
12576,1,False,215,44,259,24,3,pass
12577,1,False,2,1,3,2,2,pass
12578,2,True,8,7,15,4,3,pass
12579,1,True,8,7,15,4,3,pass
12580,2,True,19,2,21,5,3,pass
12581,1,True,3,2,5,3,3,fail
12583,2,True,207,212,419,21,8,pass
12584,1,True,15,19,34,7,4,pass
12589,2,True,8,1,9,2,2,fail
12590,1,True,1,0,1,1,1,fail
12591,1,True,7,1,8,1,1,fail
12594,1,True,8,4,12,3,3,fail
12595,1,True,69,69,138,1,1,fail
12596,1,True,0,0,0,1,1,fail
12597,1,True,0,0,0,1,1,fail
12598,1,True,8,2,10,2,2,fail
12599,1,True,2,2,4,1,1,fail
12600,1,True,3,3,6,1,1,fail
12601,1,True,69,69,138,1,1,fail
12602,1,True,1,0,1,1,1,fail
12603,1,True,2,2,4,2,2,fail
12608,2,True,48,0,48,5,3,fail
12609,2,True,15,2,17,4,3,fail
12613,2,True,1,0,1,1,1,fail
12614,1,True,1,0,1,1,1,fail
12615,2,True,3,3,6,2,1,fail
12617,2,True,237,177,414,15,5,fail
12618,2,True,11,1,12,2,2,fail
12620,2,True,14,9,23,6,2,pass
12621,1,True,11,1,12,2,2,fail
12622,1,True,14,9,23,6,2,fail
12623,2,True,212,167,379,7,5,fail
12624,1,True,210,163,373,4,3,fail
12627,1,True,6,5,11,2,1,pass
12628,1,True,3,3,6,2,1,fail
12629,2,True,33,0,33,2,1,fail
12633,2,True,20,59,79,6,2,fail
12634,1,True,2,50,52,1,1,pass
12635,1,True,4,4,8,1,1,fail
12638,1,True,3,0,3,2,1,fail
12639,2,True,3,0,3,2,1,fail
12640,2,True,3,0,3,2,1,pass
12641,1,True,4,2,6,1,1,fail
12643,2,True,368,203,571,16,4,pass
12644,2,True,368,203,571,16,4,pass
12645,1,True,3,0,3,2,1,fail
12646,1,True,0,1,1,1,1,fail
12647,1,True,28,82,110,9,2,fail
12648,1,True,1,2,3,1,1,fail
12649,1,True,376,155,531,15,3,fail
12650,2,True,6,4,10,6,3,pass
12651,1,True,6,4,10,6,3,fail
12652,2,True,4,3,7,3,2,pass
12653,1,True,1,0,1,1,1,fail
12655,1,False,1,1,2,1,1,pass
12656,1,False,71,19,90,14,3,pass
12658,2,True,65,50,115,13,4,pass
12659,1,True,1,1,2,1,1,pass
12660,1,True,20,6,26,2,1,fail
12661,1,True,3,0,3,2,1,fail
12663,2,True,4,2,6,2,2,pass
12664,2,True,15,26,41,7,5,pass
12665,1,True,1,0,1,1,1,fail
12668,2,True,13,19,32,3,2,fail
12669,2,True,1,6,7,3,3,pass
12670,2,True,1,6,7,3,3,pass
12671,1,True,13,19,32,3,2,pass
12672,1,True,3,2,5,1,1,pass
12673,1,True,1,6,7,3,3,pass
12675,2,True,37,24,61,10,4,pass
12676,2,True,0,1,1,1,1,pass
12677,1,True,3,0,3,3,1,fail
12679,1,True,34,24,58,7,3,fail
12681,2,True,2,2,4,1,1,pass
12682,1,True,2,2,4,1,1,pass
12683,2,True,13,4,17,3,2,fail
12684,1,True,13,4,17,3,2,pass
12685,2,True,23,10,33,3,2,pass
12686,2,True,23,7,30,6,2,pass
12687,2,True,19,4,23,4,2,pass
12688,1,True,12,3,15,2,1,fail
12690,2,True,4,3,7,2,2,fail
12691,2,True,0,0,0,1,1,pass
12693,1,True,4,3,7,2,2,pass
12694,2,True,0,0,0,1,1,pass
12695,1,True,2,0,2,1,1,fail
12697,1,False,0,0,0,1,1,fail
12698,1,False,1,1,2,1,1,pass
12699,1,False,81,20,101,19,3,pass
12700,2,True,6,5,11,4,2,pass
12701,1,True,4,0,4,2,2,pass
12703,2,True,181,32,213,17,3,pass
12704,1,True,67,12,79,1,1,pass
12707,2,True,24,2,26,5,3,pass
12708,1,True,24,2,26,5,3,fail
12709,2,True,133,148,281,16,6,pass
12710,1,True,21,0,21,1,1,pass
12711,1,True,4,0,4,1,1,pass
12713,1,True,91,109,200,10,4,fail
12715,2,True,9,4,13,2,2,pass
12716,2,True,37,28,65,7,2,pass
12717,2,True,25,5,30,4,2,pass
12718,2,True,12,23,35,4,2,pass
12719,2,True,9,21,30,3,2,pass
12720,2,True,18,3,21,5,2,pass
12721,2,True,3,2,5,2,2,pass
12722,2,True,41,7,48,8,4,pass
12723,1,True,6,2,8,1,1,pass
12724,1,True,9,4,13,2,2,fail
12725,2,True,41,7,48,8,4,pass
12726,1,True,25,5,30,4,2,fail
12727,1,True,0,0,0,1,1,fail
12728,1,True,3,2,5,2,2,fail
12729,1,True,2,3,5,1,1,pass
12730,2,True,15,1,16,3,2,fail
12731,1,True,15,1,16,3,2,pass
12732,1,True,3,11,14,1,1,pass
12735,2,True,2,1,3,2,2,fail
12736,2,True,23,4,27,2,2,fail
12737,2,True,23,4,27,2,2,fail
12738,1,True,2,2,4,1,1,pass
12739,1,True,2,1,3,2,2,fail
12740,1,True,22,3,25,2,2,pass
12741,1,False,1,1,2,1,1,fail
12742,1,False,668,225,893,108,5,fail
12743,1,False,4,1,5,2,2,pass
12744,1,False,1,0,1,1,1,pass
12745,2,True,239,17,256,19,3,fail
12746,2,True,2,4,6,3,2,fail
12747,1,True,222,0,222,2,2,fail
12748,1,False,2,4,6,3,2,pass
12749,1,True,17,17,34,17,1,fail
12750,1,False,1,1,2,1,1,pass
12751,1,False,1031,868,1899,2,2,fail
12752,1,False,44,44,88,3,1,pass
12754,1,False,9,7,16,1,1,fail
12755,1,False,56,16,72,1,1,pass
12756,2,True,150,42,192,6,2,fail
12757,2,True,19,7,26,3,2,pass
12758,2,True,19,7,26,3,2,pass
12759,1,True,1,0,1,1,1,pass
12760,2,True,10128,872,11000,103,9,fail
12761,2,True,9459,824,10283,82,7,pass
12762,2,True,36,21,57,8,4,pass
12763,1,True,12,9,21,5,3,pass
12764,1,True,2,4,6,1,1,fail
12765,1,True,1,0,1,1,1,fail
12767,2,True,43,8,51,4,3,fail
12768,1,True,10,8,18,1,1,fail
12769,1,True,3,2,5,1,1,fail
12770,1,True,1,1,2,1,1,fail
12771,1,True,1,1,2,1,1,fail
12774,2,True,9383,798,10181,73,6,fail
12775,2,True,284,23,307,7,2,fail
12776,1,True,32,1,33,2,1,pass
12777,1,True,0,1,1,1,1,fail
12778,1,True,1,4,5,2,1,fail
12779,1,True,228,12,240,3,1,fail
12780,1,True,4,4,8,1,1,fail
12781,1,True,1,1,2,1,1,fail
12785,1,True,1,1,2,1,1,fail
12786,1,True,45,16,61,1,1,fail
12787,1,True,108,74,182,3,2,fail
12788,2,True,86,26,112,3,2,fail
12790,1,True,13,11,24,2,1,fail
12792,2,True,86,26,112,3,2,fail
12793,2,True,86,26,112,3,2,pass
12794,1,True,8071,257,8328,48,5,fail
12796,1,True,1,3,4,1,1,fail
12797,2,True,584,23,607,23,6,fail
12799,2,True,8,4,12,2,2,pass
12800,2,True,8,4,12,2,2,pass
12801,1,True,8,4,12,2,2,pass
12802,2,True,576,19,595,21,6,pass
12803,1,True,2,0,2,1,1,fail
12804,2,True,2,0,2,1,1,fail
12806,2,True,576,19,595,21,6,fail
12807,1,True,4,0,4,2,1,fail
12808,1,True,99,8,107,2,1,fail
12809,1,True,476,15,491,18,6,fail
12811,2,True,2,0,2,1,1,fail
12812,1,True,1,1,2,1,1,pass
12813,1,True,3,3,6,1,1,fail
12814,1,True,3,1,4,1,1,fail
12815,2,True,7818,6100,13918,214,21,pass
12816,2,True,2,0,2,1,1,pass
12817,1,True,1,1,2,2,2,fail
12819,1,True,2,0,2,1,1,pass
12820,2,True,44,9,53,7,4,fail
12821,1,True,1,1,2,1,1,fail
12822,1,True,45,10,55,7,4,fail
12823,2,True,2,2,4,2,2,pass
12824,1,True,2,2,4,2,2,pass
12828,2,True,3,4,7,2,1,pass
12830,1,True,1,1,2,1,1,fail
12831,1,True,2,3,5,1,1,fail
12832,1,True,1,1,2,1,1,fail
12833,1,True,234,61,295,16,6,fail
12834,1,False,1,1,2,1,1,fail
12835,1,False,1,1,2,1,1,fail
12837,1,False,10,7,17,2,2,pass
12839,1,False,2,2,4,1,1,fail
12840,1,False,69,14,83,3,2,pass
12841,1,False,13,7,20,1,1,fail
12842,1,False,1,1,2,1,1,fail
12843,1,False,1,1,2,1,1,fail
12844,1,False,106,40,146,1,1,fail
12845,2,True,6792,5835,12627,168,11,fail
12846,2,True,12,10,22,3,2,fail
12847,1,True,323,0,323,5,1,pass
12848,2,True,12,10,22,3,2,pass
12849,2,True,14,5,19,2,2,fail
12850,1,True,6,3,9,1,1,fail
12851,1,True,1,0,1,1,1,fail
12862,2,True,14,5,19,2,2,fail
12863,1,True,13,5,18,1,1,fail
12864,1,True,1,0,1,1,1,fail
12865,1,True,9,10,19,3,2,fail
12866,2,True,140,42,182,3,2,fail
12867,1,True,1,1,2,1,1,pass
12868,2,True,308,73,381,5,4,fail
12869,2,True,308,73,381,5,4,fail
12870,2,True,98348,34030,132378,300,20,fail
12871,1,True,9,1,10,1,1,fail
12872,2,True,13,6,19,5,3,fail
12874,2,True,4,0,4,1,1,pass
12875,2,True,101,33,134,19,9,fail
12876,2,True,4,5,9,3,2,pass
12877,2,True,11,6,17,7,3,fail
12878,2,True,5,1,6,1,1,pass
12879,2,True,64672,26522,91194,300,24,pass
12880,2,True,6,5,11,6,3,pass
12881,2,True,6,5,11,6,3,fail
12882,2,True,86,22,108,9,7,fail
12883,2,True,86,22,108,9,7,fail
12884,1,True,14,21,35,1,1,pass
12886,2,True,86,22,108,9,7,fail
12887,1,True,1,0,1,1,1,fail
12888,1,True,1,3,4,1,1,fail
12889,1,True,1,3,4,1,1,fail
12890,2,True,15665,642,16307,103,12,fail
12891,1,True,1,1,2,2,2,fail
12892,1,True,1,1,2,1,1,fail
12897,2,True,15665,642,16307,103,12,fail
12898,2,True,15665,642,16307,103,12,fail
12899,2,True,15665,642,16307,103,12,fail
12900,2,True,15665,642,16307,103,12,pass
12901,1,True,2,1,3,1,1,pass
12903,1,True,1,1,2,1,1,fail
12904,1,True,1,1,2,1,1,fail
12905,1,True,52,25,77,2,1,fail
12906,1,True,4,0,4,1,1,fail
12907,1,True,8,8,16,2,1,fail
12911,1,True,12,4,16,2,1,fail
12912,1,True,34,34,68,1,1,fail
12913,1,True,110,19,129,5,2,fail
12914,1,True,14151,230,14381,82,8,fail
12915,1,True,85,6,91,4,4,fail
12916,1,True,3,1,4,1,1,fail
12917,1,True,2,3,5,2,2,fail
12918,1,True,322,880,1202,15,4,fail
12919,2,True,40,8,48,1,1,fail
12920,2,True,49045,25998,75043,300,16,fail
12922,2,True,40,8,48,1,1,fail
12923,2,True,48983,25998,74981,300,15,fail
12924,2,True,49013,25998,75011,300,16,fail
12925,2,True,48979,25994,74973,300,15,fail
12926,1,True,5,1,6,1,1,fail
12927,1,True,2,0,2,1,1,fail
12929,1,True,1,1,2,1,1,fail
12975,1,True,62,12,74,3,1,fail
12977,1,True,1,1,2,1,1,fail
12978,1,True,8,2,10,1,1,fail
12979,1,True,32,6,38,1,1,fail
12981,1,True,1,1,2,1,1,fail
12982,1,True,2,2,4,1,1,fail
12983,1,True,93,35,128,6,2,fail
12984,2,True,344,279,623,62,11,fail
12985,1,True,1,1,2,1,1,fail
12986,1,True,2,2,4,1,1,fail
12987,1,True,2,2,4,1,1,fail
12988,1,True,1,0,1,1,1,fail
12989,1,True,5,5,10,5,3,fail
12992,1,True,1,1,2,1,1,fail
12993,2,True,38,41,79,16,8,fail
12994,1,True,1,1,2,1,1,fail
12995,1,True,37,40,77,16,8,fail
12996,1,True,5,1,6,1,1,fail
12997,1,True,18,0,18,2,1,fail
12998,1,True,1,1,2,1,1,fail
13003,2,True,5,1,6,1,1,fail
13004,2,True,2,6,8,3,3,fail
13005,1,True,2,0,2,1,1,fail
13006,2,True,2,0,2,2,2,pass
13007,2,True,0,6,6,1,1,pass
13009,1,True,3,1,4,1,1,fail
13010,1,True,2,0,2,2,2,pass
13011,1,True,0,6,6,1,1,pass
13013,1,True,1,1,2,1,1,pass
13015,2,True,3,2,5,3,2,pass
13016,1,True,0,0,0,1,1,fail
13018,2,True,1,1,2,1,1,pass
13019,2,True,1,1,2,1,1,pass
13020,1,True,1,1,2,1,1,pass
13021,1,True,1,1,2,1,1,pass
13022,2,True,4,4,8,2,2,pass
13023,2,True,4,4,8,2,2,pass
13026,1,True,2,2,4,1,1,pass
13028,1,True,2,2,4,1,1,pass
13029,1,True,1,1,2,1,1,pass
13030,2,True,7,0,7,2,1,pass
13031,1,True,0,0,0,1,1,fail
13032,2,True,7,0,7,2,1,fail
13034,2,True,3,1,4,2,2,pass
13036,2,True,3,1,4,2,2,pass
13038,1,True,0,0,0,1,1,fail
13039,2,True,3,1,4,2,2,pass
13041,2,True,3,1,4,2,2,pass
13042,1,True,1,1,2,1,1,fail
13043,2,True,3,1,4,2,2,pass
13044,1,True,3,1,4,2,2,pass
13045,1,True,10,0,10,2,1,pass
13046,2,True,126,173,299,30,3,pass
13047,1,True,2,1,3,2,1,fail
13048,2,True,126,173,299,30,3,pass
13049,1,True,126,173,299,30,3,pass
13051,1,True,2,4,6,2,1,pass
13053,1,True,1,0,1,1,1,pass
13056,1,True,1,0,1,1,1,pass
13057,1,True,9,7,16,2,1,fail
13059,1,True,1,0,1,1,1,pass
13060,1,True,1,1,2,1,1,fail
13061,2,True,17,7,24,6,3,pass
13062,1,True,0,3,3,1,1,pass
13063,1,True,2,2,4,1,1,fail
13064,1,True,1,1,2,1,1,fail
13065,1,True,0,10,10,1,1,fail
13066,1,True,3,3,6,2,1,fail
13067,1,True,3,3,6,2,1,fail
13068,1,True,1,0,1,1,1,fail
13069,1,True,27,5,32,5,2,fail
13070,1,True,30,0,30,1,1,fail
13071,2,True,5,8,13,1,1,pass
13072,2,True,8,10,18,1,1,pass
13073,2,True,8,10,18,1,1,pass
13074,1,True,8,10,18,1,1,pass
13075,1,True,5,8,13,1,1,pass
13076,1,False,1,1,2,1,1,pass
13077,2,True,1,1,2,1,1,pass
13078,1,True,1,1,2,1,1,pass
13079,2,True,16,5,21,5,2,fail
13080,1,True,2,0,2,1,1,pass
13081,1,True,14,5,19,4,1,fail
13082,2,True,1,1,2,1,1,pass
13083,1,True,1,1,2,1,1,pass
13084,2,True,3,10,13,1,1,pass
13085,2,True,7,6,13,4,3,pass
13086,2,True,7,6,13,4,3,fail
13087,1,True,2,1,3,3,2,pass
13088,1,True,3,10,13,1,1,pass
13089,1,True,2,2,4,2,2,fail
13090,1,True,4,4,8,1,1,fail
13091,1,True,1,1,2,1,1,fail
13092,2,True,1,1,2,2,2,pass
13093,2,True,3986,858,4844,14,4,pass
13094,2,True,73,17,90,5,2,pass
13095,2,True,3913,841,4754,10,4,pass
13096,2,True,3913,841,4754,10,4,pass
13097,1,True,262,4,266,2,2,pass
13098,1,True,1,0,1,1,1,fail
13099,2,True,37769,14141,51910,300,19,fail
13100,1,True,1,1,2,2,2,pass
13102,1,True,3,1,4,1,1,pass
13103,1,True,9,2,11,1,1,fail
13104,2,True,115,82,197,10,3,fail
13105,1,True,10,10,20,3,1,fail
13106,2,True,5,5,10,2,2,pass
13107,2,True,109,76,185,7,3,pass
13108,2,True,109,76,185,7,3,pass
13109,2,True,1,1,2,1,1,pass
13110,1,True,5,5,10,2,2,pass
13111,2,True,1,1,2,1,1,pass
13112,1,True,1,1,2,1,1,pass
13113,1,True,4,4,8,1,1,pass
13119,2,True,5,0,5,1,1,fail
13121,2,True,5,0,5,1,1,pass
13122,2,True,2637,945,3582,71,20,pass
13123,2,True,2637,945,3582,71,20,pass
13124,2,True,1206,1726,2932,292,21,pass
13125,2,True,9,3,12,4,2,pass
13127,1,True,1,1,2,1,1,pass
13128,1,True,4,3,7,2,1,fail
13129,1,True,8,5,13,2,1,fail
13130,1,True,74,17,91,6,1,fail
13131,1,True,4,7,11,1,1,fail
13132,1,True,7,7,14,2,1,fail
13133,1,True,0,4,4,1,1,fail
13134,1,True,1,1,2,1,1,fail
13135,1,True,25,11,36,2,1,fail
13136,1,True,117,567,684,6,3,fail
13138,2,True,7,2,9,2,2,pass
13139,1,True,1,0,1,1,1,pass
13140,1,True,6,2,8,1,1,fail
13141,1,True,39,2,41,1,1,fail
13142,1,True,47,6,53,1,1,fail
13143,1,True,18,17,35,2,2,fail
13144,1,True,268,226,494,11,1,fail
13146,2,True,2,1,3,2,2,fail
13148,1,True,1,0,1,1,1,pass
13150,2,True,37,47,84,4,4,pass
13151,2,True,0,0,0,0,0,pass
13152,1,True,37,47,84,4,4,fail
13153,2,True,190,74,264,10,3,pass
13154,2,True,49,253,302,14,3,pass
13156,2,True,49,253,302,14,3,fail
13157,1,True,8,4,12,2,1,fail
13158,1,True,67,55,122,5,2,fail
13159,2,True,2,1,3,2,2,pass
13161,2,True,47,252,299,12,1,pass
13163,1,True,47,252,299,12,1,pass
13164,1,True,1,1,2,1,1,fail
13165,1,True,2,1,3,2,2,fail
13166,1,False,7,1,8,3,3,pass
13167,2,True,185,83,268,6,2,fail
13168,2,True,23,10,33,3,2,fail
13170,2,True,23,10,33,3,2,fail
13171,2,True,4,4,8,1,1,pass
13172,1,False,4,4,8,1,1,pass
13173,2,True,359,617,976,231,12,fail
13174,2,True,63,17,80,3,2,fail
13175,2,True,462,763,1225,237,14,pass
13176,1,False,1,1,2,1,1,pass
13177,1,False,3,3,6,1,1,fail
13178,2,True,11,3,14,3,2,fail
13179,2,True,281,594,875,228,12,fail
13180,2,True,281,594,875,228,12,fail
13181,1,True,35,42,77,3,3,fail
13185,1,True,3,0,3,1,1,fail
13186,2,True,351,218,569,29,6,fail
13187,1,True,1,1,2,1,1,fail
13188,1,True,5,1,6,1,1,fail
13193,2,True,406,693,1099,49,10,fail
13194,2,True,177,173,350,17,5,fail
13195,2,True,12,7,19,3,1,fail
13197,1,False,2,2,4,1,1,fail
13198,1,False,6,4,10,2,1,fail
13199,1,False,1,1,2,1,1,fail
13200,1,True,48,147,195,2,2,fail
13203,1,False,2,0,2,2,1,fail
13204,1,False,5,2,7,4,1,fail
13205,1,False,0,34,34,2,1,pass
13206,1,False,2,2,4,1,1,fail
13207,1,False,6,0,6,1,1,fail
13208,1,False,9,10,19,1,1,fail
13209,1,False,10,9,19,1,1,fail
13210,1,False,1,1,2,1,1,fail
13211,1,False,61,1,62,3,1,fail
13212,1,False,0,1,1,1,1,fail
13213,1,False,9,0,9,2,1,fail
13214,2,True,16,5,21,2,1,pass
13215,1,True,1,0,1,1,1,fail
13216,1,True,14,4,18,1,1,fail
13219,1,True,1,1,2,1,1,pass
13221,2,True,98,27,125,6,2,pass
13222,2,True,4,3,7,2,1,fail
13223,2,True,4,3,7,2,1,pass
13224,1,True,4,3,7,2,1,pass
13225,1,True,16,12,28,3,1,pass
13226,1,True,1,0,1,1,1,fail
13227,1,True,85,19,104,3,1,fail
13228,2,True,44,468,512,20,6,pass
13229,2,True,14,1,15,3,2,pass
13230,2,True,14,2,16,4,3,pass
13232,2,True,18,467,485,16,6,pass
13233,1,True,1,0,1,1,1,fail
13234,2,True,1,1,2,1,1,pass
13235,2,True,33620,12240,45860,300,21,fail
13236,2,True,1,1,2,2,2,pass
13237,2,True,33549,12239,45788,300,21,fail
13238,2,True,19841,8564,28405,300,20,pass
13239,1,True,1,0,1,1,1,fail
13240,2,True,5,5,10,2,2,pass
13241,1,True,1,0,1,1,1,fail
13242,2,True,22,468,490,14,5,fail
13243,2,True,1,364,365,6,4,pass
13244,2,True,21,104,125,10,4,fail
13245,2,True,9,0,9,2,2,pass
13246,2,True,10815,3758,14573,183,17,pass
13247,2,True,1,96,97,5,4,pass
13248,2,True,11,8,19,3,2,fail
13250,1,True,5,1,6,1,1,pass
13251,1,True,7,0,7,1,1,pass
13252,2,True,11,8,19,3,2,fail
13253,2,True,11,8,19,3,2,pass
13254,1,True,7,11,18,3,1,pass
13255,1,True,3,2,5,1,1,fail
13256,1,True,4,1,5,2,1,fail
13257,1,True,2,0,2,2,2,fail
13258,2,True,10770,3669,14439,175,15,fail
13259,2,True,10770,3669,14439,175,15,pass
13260,2,True,10770,3669,14439,175,15,pass
13261,2,True,10769,3668,14437,175,15,fail
13262,2,True,10770,3669,14439,175,15,pass
13263,2,True,10770,3669,14439,175,15,pass
13264,2,True,10762,3662,14424,173,14,pass
13266,1,True,6,6,12,1,1,pass
13268,1,True,26,60,86,3,2,pass
13272,1,True,24,2,26,13,1,fail
13275,1,True,157,86,243,15,4,fail
13276,1,True,1,1,2,1,1,fail
13277,1,True,14,10,24,1,1,fail
13278,1,True,71,58,129,8,5,fail
13296,2,True,1,1,2,1,1,pass
13298,2,True,7,6,13,2,2,fail
13301,1,True,8,7,15,2,1,fail
13303,1,True,2,2,4,1,1,fail
13305,1,True,1,96,97,5,4,fail
13306,1,True,1,364,365,6,4,fail
13307,1,True,8,1,9,2,1,fail
13311,1,True,7,6,13,2,2,fail
13312,2,True,52,4,56,6,4,fail
13313,2,True,2,2,4,1,1,pass
13314,1,True,2,2,4,1,1,fail
13315,1,True,1,1,2,1,1,fail
13316,2,True,5,0,5,2,2,pass
13317,1,True,1,0,1,1,1,fail
13318,1,True,4,0,4,1,1,fail
13319,1,False,2,0,2,1,1,fail
13320,1,False,1,1,2,1,1,fail
13321,1,False,1,1,2,1,1,fail
13322,2,True,42,1,43,2,1,pass
13323,1,False,1,1,2,1,1,fail
13326,1,True,21,0,21,1,1,fail
13328,1,True,4,5,9,1,1,fail
13329,1,True,1,0,1,1,1,pass
13330,1,True,8,0,8,1,1,pass
13331,2,True,23,2,25,3,2,pass
13332,1,True,21,9,30,2,1,pass
13335,2,True,32,31,63,5,2,pass
13336,1,True,2,1,3,3,1,pass
13338,2,True,4,0,4,1,1,pass
13341,2,True,8541,4123,12664,180,13,fail
13344,2,True,2,0,2,2,1,pass
13345,2,True,2,1,3,2,2,pass
13346,1,True,1,1,2,1,1,pass
13347,2,True,0,0,0,1,1,pass
13348,1,True,0,0,0,1,1,pass
13349,2,True,2,1,3,1,1,pass
13350,2,True,2,1,3,1,1,pass
13351,2,True,7696,3992,11688,169,9,pass
13352,2,True,7696,3992,11688,169,9,fail
13353,2,True,7696,3989,11685,169,9,pass
13354,2,True,7696,3992,11688,169,9,pass
13355,2,True,7696,3992,11688,169,9,pass
13356,1,True,0,7,7,1,1,pass
13357,1,True,48,33,81,1,1,fail
13358,2,True,537,237,774,21,6,pass
13359,1,True,3,3,6,1,1,pass
13360,1,True,0,1,1,1,1,fail
13361,1,True,3,2,5,1,1,fail
13362,1,True,2,2,4,1,1,fail
13363,1,True,64,21,85,4,1,fail
13365,1,True,24,4,28,1,1,fail
13366,1,True,79,7,86,3,1,fail
13367,1,True,1,0,1,1,1,pass
13368,1,True,8,29,37,2,1,fail
13369,1,True,12,14,26,1,1,fail
13370,1,True,1,1,2,1,1,fail
13372,1,True,3,3,6,1,1,fail
13373,1,True,28,17,45,3,2,fail
13374,1,True,4,2,6,1,1,fail
13375,1,True,43,21,64,5,2,fail
13376,1,True,325,343,668,16,2,fail
13379,1,True,6765,3101,9866,138,7,fail
13381,1,True,0,6,6,1,1,pass
13382,2,True,537,237,774,21,6,fail
13383,1,True,1,1,2,1,1,pass
13385,2,True,528,235,763,21,6,fail
13386,2,True,537,237,774,21,6,pass
13387,1,True,67,40,107,6,2,pass
13404,2,True,82,38,120,14,3,pass
13405,1,True,1,3,4,1,1,fail
13407,2,True,29,24,53,4,2,pass
13408,2,True,29,24,53,4,2,pass
13409,2,True,14,3,17,4,3,fail
13410,1,True,1,1,2,1,1,fail
13411,1,True,14,8,22,1,1,pass
13412,2,True,9,0,9,1,1,pass
13413,1,True,0,0,0,1,1,pass
13414,1,False,0,0,0,1,1,pass
13415,1,False,9,0,9,1,1,pass
13416,2,True,57,237,294,15,3,pass
13419,2,True,2,1,3,2,1,pass
13420,2,True,14859,5011,19870,215,23,pass
13421,2,True,3,2,5,1,1,pass
13422,1,True,1,0,1,1,1,pass
13423,1,True,21,23,44,3,1,fail
13424,2,True,14856,5009,19865,215,23,pass
13425,1,True,33,19,52,2,2,pass
13426,2,True,7,4,11,2,1,pass
13427,2,True,14849,5005,19854,214,23,pass
13428,1,True,1,1,2,1,1,pass
13429,1,True,1,1,2,1,1,pass
13432,1,True,0,3,3,1,1,pass
13433,2,True,30,2,32,3,2,pass
13434,2,True,14817,4998,19815,210,23,pass
13435,2,True,9,223,232,4,3,pass
13436,2,True,9,223,232,4,3,pass
13437,2,True,14808,4775,19583,206,23,pass
13438,2,True,14808,4775,19583,206,23,pass
13439,2,True,14808,4775,19583,206,23,pass
13440,2,True,4,0,4,2,2,pass
13441,1,True,1,0,1,1,1,pass
13442,1,True,3,0,3,1,1,pass
13443,2,True,14804,4775,19579,205,23,pass
13444,1,True,6,0,6,6,1,pass
13445,1,True,3,3,6,1,1,pass
13446,1,True,7,7,14,5,1,fail
13448,1,True,1726,1117,2843,52,8,fail
13453,1,True,1021,0,1021,5,3,pass
13454,1,True,398,0,398,1,1,fail
13455,1,True,240,167,407,4,1,fail
13456,1,True,2,4,6,1,1,pass
13457,1,True,581,256,837,6,2,fail
13459,1,True,21,14,35,5,2,pass
13460,1,True,62,31,93,5,1,pass
13461,1,True,658,538,1196,5,1,fail
13462,1,True,3,8,11,2,1,pass
13463,1,True,57,35,92,4,1,pass
13465,1,True,9,223,232,4,3,fail
13466,1,True,0,1,1,1,1,fail
13467,1,True,6,2,8,1,1,fail
13472,1,True,47,17,64,1,1,pass
13473,1,True,9,12,21,2,1,fail
13474,1,True,87,32,119,2,1,fail
13477,1,True,1,1,2,1,1,fail
13478,1,True,10,11,21,3,1,fail
13479,1,True,1,0,1,1,1,fail
13483,1,True,14,10,24,3,1,fail
13484,1,True,4,0,4,1,1,fail
13485,1,True,5,8,13,1,1,fail
13486,1,True,42,37,79,7,1,fail
13487,1,True,2,2,4,1,1,fail
13490,1,True,9,8,17,4,1,fail
13491,1,True,8,3,11,4,2,fail
13492,2,True,173,70,243,14,4,fail
13493,1,True,19,13,32,4,1,fail
13494,1,True,10,5,15,3,2,fail
13495,1,True,2,1,3,2,1,fail
13496,1,True,4,4,8,2,1,fail
13497,1,True,1,1,2,1,1,fail
13498,1,True,8,9,17,2,1,fail
13499,1,True,7,8,15,1,1,fail
13501,1,True,1,1,2,1,1,fail
13502,1,True,4,3,7,2,1,fail
13504,1,True,12,20,32,3,3,fail
13505,1,True,207,224,431,1,1,fail
13506,1,True,95,4,99,1,1,fail
13507,1,True,37,163,200,2,2,fail
13513,1,True,5,1,6,1,1,fail
13514,1,True,0,7,7,1,1,fail
13515,1,True,113,122,235,7,1,fail
13516,1,True,1,5,6,10,4,fail
13517,1,True,1,0,1,1,1,fail
13519,1,True,7,57,64,5,1,fail
13523,1,True,2,2,4,1,1,fail
13524,1,True,3,2,5,1,1,fail
13525,1,True,1,1,2,2,2,fail
13526,1,True,2,1,3,2,1,fail
13527,1,True,3362,758,4120,31,3,fail
13528,1,True,1,0,1,1,1,fail
13531,1,True,13,1,14,2,1,fail
13532,1,True,10,2,12,2,1,fail
13539,1,True,16,10,26,4,1,fail
13540,1,True,4,0,4,1,1,fail
13541,1,True,24,7,31,3,1,fail
13542,1,True,6,1,7,1,1,fail
13543,1,True,16,11,27,2,2,fail
13547,2,True,177,69,246,26,5,pass
13548,2,True,25,9,34,3,2,pass
13549,2,True,2,0,2,2,1,pass
13550,2,True,2,0,2,2,1,pass
13551,1,True,2,0,2,2,1,pass
13552,2,True,32,5,37,4,2,pass
13553,2,True,32,5,37,4,2,pass
13554,2,True,21,6,27,5,2,pass
13555,2,True,39,14,53,11,3,pass
13556,2,True,3,2,5,2,2,pass
13557,2,True,18,4,22,3,2,pass
13558,2,True,18,4,22,3,2,pass
13559,1,True,1,1,2,1,1,pass
13562,1,True,2,1,3,1,1,pass
13563,1,True,8,9,17,2,1,pass
13564,1,True,34,7,41,5,2,fail
13565,1,True,3,2,5,2,2,pass
13566,2,True,1,1,2,1,1,pass
13567,1,True,1,1,2,1,1,pass
13568,2,True,5,1,6,3,2,pass
13569,2,True,9,0,9,1,1,pass
13570,1,False,9,0,9,1,1,pass
13571,1,True,5,1,6,3,2,pass
13572,2,True,1,2,3,1,1,pass
13573,2,True,0,2,2,1,1,pass
13574,2,True,0,2,2,1,1,pass
13575,1,True,1,2,3,1,1,fail
13576,1,True,0,2,2,1,1,pass
13577,1,True,1,1,2,1,1,pass
13578,1,True,0,1,1,1,1,pass
13579,1,True,1,1,2,1,1,pass
13580,1,True,29,28,57,4,2,fail
13581,2,True,2,2,4,1,1,pass
13582,1,True,2,2,4,1,1,pass
13583,1,True,8,0,8,1,1,pass
13585,2,True,8,8,16,2,1,pass
13586,2,True,3,2,5,3,2,pass
13587,1,True,4,22,26,2,1,fail
13588,2,True,2,1,3,2,2,pass
13589,1,True,1,1,2,1,1,pass
13590,1,True,1,0,1,1,1,pass
13591,1,True,1,1,2,1,1,pass
13592,1,True,1,1,2,1,1,fail
13593,2,True,1,1,2,1,1,pass
13594,1,True,1,1,2,1,1,pass
13595,2,True,68,31,99,9,2,pass
13596,1,True,20,4,24,1,1,fail
13597,2,True,4,0,4,2,2,pass
13598,2,True,64,31,95,7,2,pass
13599,2,True,16,2,18,3,2,pass
13600,1,True,14,0,14,1,1,pass
13601,2,True,48,29,77,4,2,pass
13602,2,True,48,29,77,4,2,pass
13603,1,True,23,23,46,2,1,pass
13604,1,True,2,1,3,1,1,pass
13605,1,True,1,1,2,1,1,fail
13606,1,True,29,12,41,2,1,fail
13608,1,True,40,20,60,2,1,pass
13609,1,True,0,0,0,1,1,pass
13610,1,True,1,0,1,1,1,fail
13611,1,True,1,2,3,1,1,fail
13612,1,True,1,0,1,1,1,pass
13613,1,True,1,1,2,1,1,fail
13614,1,True,2,0,2,1,1,pass
13615,2,True,0,1,1,1,1,pass
13617,1,True,2,1,3,1,1,pass
13618,1,True,2,0,2,1,1,pass
13619,2,True,197,193,390,40,3,pass
13621,2,True,0,2,2,1,1,pass
13622,1,True,0,2,2,1,1,pass
13623,2,True,10,1,11,4,3,pass
13624,2,True,187,190,377,38,1,pass
13625,2,True,187,189,376,38,1,pass
13626,2,True,0,1,1,1,1,pass
13627,2,True,0,1,1,1,1,fail
13628,1,True,1,0,1,1,1,pass
13629,1,True,0,1,1,1,1,pass
13632,1,True,2,2,4,3,2,pass
13633,1,True,1,2,3,1,1,fail
13634,1,True,11,1,12,4,3,fail
13635,2,True,1,1,2,1,1,pass
13637,2,True,1,1,2,1,1,pass
13639,2,True,2,2,4,1,1,pass
13640,2,True,2,2,4,1,1,pass
13641,1,True,3,9,12,1,1,fail
13642,2,True,2,2,4,1,1,pass
13646,1,True,1,1,2,1,1,pass
13647,1,True,2,2,4,1,1,pass
13648,2,True,27,2,29,3,2,pass
13649,2,True,22,8,30,2,2,pass
13650,2,True,22,8,30,2,2,pass
13651,1,True,22,8,30,2,2,pass
13652,1,True,27,2,29,3,2,pass
13653,2,True,12,0,12,3,2,pass
13654,1,True,12,0,12,3,2,pass
13655,2,True,16,18,34,1,1,pass
13656,1,True,16,18,34,1,1,pass
13657,2,True,139,178,317,26,2,pass
13658,2,True,1,1,2,1,1,pass
13659,1,True,1,1,2,1,1,pass
13660,2,True,123,124,247,1,1,pass
13661,1,True,123,124,247,1,1,pass
13662,1,False,1,1,2,1,1,pass
13665,2,True,6,6,12,1,1,pass
13666,1,False,6,6,12,1,1,pass
13668,1,True,47,81,128,2,2,pass
13671,1,True,41,24,65,1,1,fail
13672,2,True,0,0,0,0,0,fail
13674,2,True,264,101,365,17,9,pass
13675,1,True,1,1,2,1,1,pass
13676,1,True,38,27,65,4,3,fail
13677,2,True,54,33,87,4,2,fail
13679,2,True,54,33,87,4,2,pass
13681,1,True,215,76,291,11,6,fail
13682,1,True,54,33,87,4,2,pass
13683,2,True,80,42,122,10,4,pass
13684,1,True,23,0,23,1,1,pass
13686,1,True,42,39,81,2,2,fail
13687,1,True,1,1,2,1,1,fail
13688,2,True,30,283,313,5,2,pass
13689,1,True,1,1,2,1,1,pass
13690,1,True,13,277,290,3,2,fail
13692,2,True,6,0,6,2,2,pass
13693,2,True,164,64,228,14,7,fail
13694,2,True,164,64,228,14,7,pass
13695,1,True,6,0,6,2,2,pass
13696,1,True,113,5,118,6,3,pass
13697,1,True,2,2,4,1,1,fail
13698,1,True,6,3,9,2,1,fail
13699,1,True,3,3,6,1,1,fail
13700,1,True,36,54,90,7,5,fail
13703,2,True,92,33,125,12,4,pass
13704,1,True,4,0,4,1,1,pass
13705,2,True,33,6,39,3,2,fail
13706,2,True,196,59,255,12,3,fail
13707,2,True,0,0,0,0,0,pass
13708,2,True,0,0,0,0,0,fail
13711,1,True,19,17,36,1,1,fail
13712,1,True,19,17,36,1,1,fail
13713,1,True,116,21,137,3,1,pass
13715,1,True,116,21,137,3,1,fail
13718,1,True,19,7,26,1,1,fail
13719,1,True,19,7,26,1,1,fail
13720,1,True,1,1,2,1,1,fail
13721,1,True,1,1,2,1,1,fail
13722,1,True,39,16,55,6,2,fail
13723,1,True,39,16,55,6,2,fail
13724,1,True,3,1,4,3,2,pass
13727,1,True,6,6,12,1,1,fail
13728,1,True,7,6,13,2,1,fail
13729,1,True,6,6,12,2,1,fail
13733,1,True,23,1,24,3,2,fail
13734,2,True,12,9,21,1,1,fail
13736,2,True,12,9,21,1,1,pass
13737,2,True,12,9,21,1,1,pass
13738,1,True,12,9,21,1,1,pass
13739,1,True,3,0,3,2,2,pass
13740,2,True,25,9,34,5,2,pass
13741,2,True,0,0,0,0,0,pass
13742,2,True,112,48,160,4,1,pass
13743,1,True,5,2,7,2,1,pass
13745,1,True,10,0,10,3,2,pass
13746,1,True,4,1,5,1,1,pass
13747,1,True,10,1,11,2,1,fail
13748,1,True,7,0,7,1,1,pass
13749,1,True,71,8,79,2,1,pass
13751,2,True,13,2,15,2,2,pass
13752,2,True,32,8,40,2,2,pass
13753,2,True,32,8,40,2,2,pass
13754,1,True,1,0,1,1,1,pass
13756,1,True,1,2,3,1,1,pass
13757,2,True,0,0,0,0,0,pass
13759,2,True,72,31,103,9,2,pass
13760,2,True,96,15,111,10,2,pass
13762,2,True,96,15,111,10,2,fail
13763,2,True,97,12,109,18,13,pass
13764,2,True,96,15,111,10,2,pass
13765,2,True,177,59,236,7,2,pass
13766,1,True,1,1,2,1,1,pass
13767,1,True,1,1,2,1,1,fail
13768,2,True,96,15,111,10,2,fail
13769,2,True,96,15,111,10,2,pass
13770,2,True,52,1,53,2,1,pass
13771,2,True,1,1,2,1,1,fail
13772,1,True,1,57,58,2,2,fail
13773,1,True,2,2,4,2,2,fail
13775,1,True,69,27,96,8,2,fail
13776,2,True,93,22,115,8,2,fail
13777,2,True,87,15,102,5,2,pass
13781,1,True,1,2,3,2,1,fail
13782,2,True,87,15,102,5,2,pass
13783,1,True,52,26,78,4,1,fail
13785,1,True,3,1,4,3,2,fail
13786,2,True,133,109,242,2,2,pass
13788,1,True,2,1,3,1,1,pass
13789,1,True,2765,218,2983,5,3,pass
13790,2,True,52,1,53,2,1,pass
13791,1,True,4,1,5,1,1,fail
13792,2,True,40,16,56,5,2,pass
13793,1,True,0,1,1,1,1,pass
13794,1,True,13,2,15,3,2,fail
13795,1,True,1,0,1,1,1,pass
13796,1,True,2,0,2,1,1,fail
13797,1,True,4,1,5,2,1,fail
13799,2,True,30,9,39,2,1,pass
13800,1,True,30,9,39,2,1,pass
13801,2,True,5,5,10,1,1,pass
13802,2,True,231,159,390,68,7,pass
13803,1,True,43,4,47,5,2,fail
13804,2,True,5,2,7,2,2,pass
13805,1,True,10,7,17,4,1,pass
13806,1,True,1,0,1,1,1,pass
13807,1,True,3,3,6,1,1,pass
13808,1,True,3,3,6,1,1,pass
13809,1,True,21,3,24,2,1,fail
13814,2,True,46,46,92,1,1,pass
13815,2,True,18,12,30,7,3,pass
13816,2,True,46,46,92,1,1,fail
13817,2,True,46,46,92,1,1,pass
13818,1,True,46,46,92,1,1,pass
13819,1,True,1,47,48,2,2,pass
13820,1,True,2,48,50,3,3,pass
13821,1,True,1,1,2,1,1,fail
13822,1,True,1,1,2,1,1,fail
13823,1,True,1,1,2,1,1,fail
13825,1,True,1,1,2,1,1,fail
13826,1,True,6,5,11,2,1,fail
13827,1,True,6,5,11,2,1,fail
13828,1,True,5,2,7,2,2,fail
13829,1,True,48,2,50,2,2,fail
13831,1,False,1,1,2,1,1,fail
13832,1,False,207,142,349,58,6,pass
13834,1,True,5,5,10,1,1,pass
13835,2,True,3391,7439,10830,167,9,pass
13836,1,True,2,2,4,1,1,pass
13837,1,True,0,6,6,1,1,fail
13838,1,True,17,10,27,2,1,fail
13839,1,True,0,1,1,1,1,fail
13840,1,True,70,579,649,23,2,fail
13848,1,True,1,27,28,2,2,fail
13850,1,True,10,0,10,1,1,fail
13853,1,True,15,6,21,11,2,fail
13855,2,True,848,5737,6585,100,7,fail
13857,1,True,0,32,32,1,1,fail
13859,1,True,5,5,10,3,2,fail
13860,1,True,3,3,6,2,1,fail
13863,2,True,29,31,60,1,1,pass
13864,1,True,1,1,2,1,1,fail
13865,1,True,1,1,2,1,1,fail
13866,1,True,29,31,60,1,1,pass
13867,1,True,96,44,140,9,1,fail
13868,1,True,96,44,140,9,1,fail
13869,1,True,2,1,3,1,1,fail
13870,1,True,2,1,3,1,1,fail
13871,2,True,1,1,2,1,1,pass
13873,2,True,4,0,4,2,2,pass
13874,2,True,2,1,3,2,2,fail
13875,2,True,2,1,3,2,2,pass
13876,2,True,0,253,253,11,1,fail
13877,2,True,7,2,9,3,3,fail
13879,2,True,7,2,9,3,3,fail
13881,1,True,13,20,33,7,2,fail
13882,1,True,13,20,33,7,2,fail
13883,1,True,19,7,26,1,1,pass
13884,1,True,19,7,26,1,1,pass
13885,1,True,1,2,3,1,1,pass
13887,1,True,1,2,3,1,1,fail
13888,1,True,7,4,11,1,1,fail
13889,1,True,34,8,42,4,1,fail
13891,1,True,14,10,24,3,1,fail
13892,1,True,14,10,24,3,1,fail
13893,1,True,8,4,12,4,1,fail
13894,1,True,8,4,12,4,1,fail
13895,1,True,1,1,2,1,1,fail
13896,1,True,1,1,2,1,1,fail
13897,2,True,0,253,253,11,1,pass
13898,2,True,0,253,253,11,1,pass
13900,2,True,173,142,315,6,2,pass
13901,1,True,124,118,242,2,2,fail
13905,2,True,0,253,253,11,1,pass
13908,2,True,0,253,253,11,1,pass
13909,1,True,30,26,56,2,2,pass
13910,1,True,4,1,5,1,1,pass
13911,1,True,158,195,353,13,3,fail
13913,1,True,0,253,253,11,1,pass
13914,1,True,34,37,71,3,2,pass
13915,1,True,10,7,17,1,1,fail
13916,1,True,1,1,2,1,1,pass
13919,1,True,1,0,1,1,1,pass
13921,1,True,1,0,1,1,1,pass
13923,2,True,173,142,315,6,2,fail
13925,2,True,198,151,349,6,2,fail
13926,2,True,171,140,311,6,2,pass
13927,1,True,16,14,30,1,1,pass
13928,1,True,2,1,3,1,1,pass
13929,1,True,0,3,3,1,1,pass
13930,1,True,113,70,183,10,1,fail
13931,2,True,27,11,38,1,1,fail
13933,1,True,1,0,1,1,1,pass
13934,2,True,35,21,56,1,1,fail
13935,1,True,39,52,91,2,1,pass
13936,1,True,2,2,4,2,1,pass
13937,1,False,27,11,38,1,1,pass
13938,1,True,48,1,49,1,1,fail
13939,1,True,58,39,97,2,1,fail
13940,1,True,33,31,64,2,1,fail
13941,1,True,2,2,4,1,1,pass
13942,1,True,0,1,1,1,1,pass
13943,1,True,5,5335,5340,87,6,fail
13944,1,True,33,35,68,2,1,fail
13945,1,True,40,54,94,3,1,fail
13946,1,True,4,1,5,1,1,pass
13947,1,True,85,59,144,6,2,fail
13948,1,True,0,1,1,1,1,pass
13950,2,True,131,64,195,3,2,pass
13951,2,True,253,66,319,12,5,pass
13952,2,True,201,40,241,5,3,pass
13953,2,True,2,2,4,2,1,pass
13954,1,True,10,2,12,1,1,pass
13955,2,True,1,1,2,1,1,pass
13956,1,True,9,6,15,2,2,fail
13957,2,True,36,7,43,4,2,pass
13958,2,True,1,1,2,1,1,pass
13959,2,True,35,6,41,3,2,fail
13960,2,True,36,7,43,4,2,pass
13961,2,True,35,6,41,3,2,pass
13962,1,True,1,1,2,1,1,pass
13963,2,True,1,1,2,1,1,pass
13964,1,True,35,6,41,3,2,pass
13966,2,True,1,1,2,1,1,pass
13967,2,True,347,62,409,22,6,pass
13969,1,True,1,1,2,1,1,pass
13972,2,True,14,17,31,4,3,pass
13973,2,True,9,0,9,2,2,pass
13974,2,True,5,17,22,3,2,fail
13975,2,True,0,13,13,2,1,pass
13976,2,True,5,4,9,2,2,fail
13977,2,True,5,4,9,2,2,pass
13978,1,True,12,8,20,2,2,fail
13979,1,True,1,1,2,1,1,fail
13980,1,True,6,15,21,1,1,pass
13981,2,True,255,0,255,13,3,pass
13982,2,True,255,0,255,13,3,pass
13983,2,True,430,630,1060,26,7,pass
13985,2,True,255,0,255,13,3,pass
13986,2,True,255,0,255,13,3,fail
13987,1,True,5,10,15,1,1,fail
13988,1,True,16,7,23,1,1,pass
13989,2,True,0,0,0,0,0,pass
13991,2,True,255,0,255,13,3,pass
13992,1,True,1,1,2,1,1,pass
13993,1,True,1,0,1,1,1,pass
13995,2,True,78,45,123,7,1,pass
13996,2,True,175,630,805,13,4,pass
13997,2,True,0,0,0,0,0,fail
13998,2,True,78,45,123,7,1,pass
13999,2,True,97,585,682,7,4,fail
14000,1,True,6,5,11,1,1,fail
14001,1,True,4,5,9,1,1,fail
14002,2,True,97,585,682,7,4,pass
14003,2,True,97,585,682,7,4,fail
14004,1,True,80,13,93,3,2,fail
14005,1,True,13,11,24,2,2,fail
14006,1,True,208,40,248,5,3,fail
14007,1,False,2,4,6,1,1,pass
14008,1,False,1,504,505,3,3,pass
14009,1,True,0,1,1,1,1,pass
14011,1,True,94,77,171,3,1,pass
14012,1,True,1,0,1,1,1,pass
14014,2,True,1,1,2,1,1,pass
14015,1,True,1,0,1,1,1,pass
14016,1,True,2,2,4,1,1,pass
14017,1,True,12,12,24,1,1,fail
14018,2,True,1,1,2,1,1,pass
14019,1,True,1,0,1,1,1,fail
14020,1,True,68,35,103,7,1,pass
14022,2,True,1,1,2,1,1,pass
14023,1,True,1,1,2,1,1,pass
14024,2,True,23,7,30,5,2,pass
14025,2,True,0,0,0,0,0,pass
14027,2,True,560,336,896,13,3,fail
14029,2,True,1,1,2,1,1,pass
14030,2,True,1,1,2,1,1,pass
14032,1,True,269,128,397,2,1,fail
14033,1,True,1,1,2,1,1,pass
14034,1,True,2,2,4,1,1,fail
14035,1,True,2,2,4,1,1,fail
14036,2,True,5,0,5,2,2,fail
14037,1,True,301,238,539,10,2,pass
14038,2,True,16,31,47,2,2,pass
14039,2,True,19,2,21,4,2,pass
14040,2,True,19,2,21,4,2,pass
14041,1,True,16,31,47,2,2,pass
14042,1,True,19,2,21,4,2,pass
14043,2,True,721,178,899,34,6,pass
14044,2,True,33,9,42,4,2,pass
14045,2,True,15,4,19,7,5,pass
14047,2,True,10,3,13,4,3,pass
14048,2,True,5,1,6,3,3,fail
14049,2,True,5,1,6,3,3,pass
14050,2,True,34,5,39,7,3,pass
14051,2,True,34,5,39,7,3,pass
14052,2,True,34,5,39,7,3,pass
14053,1,True,7,4,11,1,1,pass
14055,1,True,2,2,4,2,2,fail
14056,1,True,5,1,6,3,3,pass
14057,1,True,2,2,4,2,2,fail
14058,1,True,13,1,14,3,2,fail
14059,1,True,3,2,5,3,2,fail
14060,1,True,15,2,17,2,2,fail
14061,2,True,29837,9404,39241,300,24,pass
14062,2,True,28,12,40,2,2,pass
14063,2,True,23,4,27,3,2,fail
14064,2,True,23,4,27,3,2,pass
14065,2,True,9135,4908,14043,254,15,pass
14066,2,True,593,150,743,18,2,pass
14067,2,True,589,148,737,17,2,pass
14068,1,True,51,34,85,3,1,pass
14069,1,True,65,38,103,3,1,fail
14070,1,True,137,67,204,3,1,fail
14071,1,True,141,37,178,2,1,fail
14072,1,True,2,1,3,1,1,fail
14073,2,True,4,2,6,2,2,pass
14074,2,True,4,2,6,2,2,fail
14076,2,True,0,0,0,0,0,fail
14078,1,True,28,12,40,2,2,pass
14079,2,True,0,0,0,0,0,fail
14080,1,True,185,36,221,8,2,fail
14081,2,True,104,11,115,11,6,pass
14082,2,True,0,0,0,0,0,pass
14083,2,True,104,11,115,11,6,pass
14084,2,True,8484,4793,13277,238,12,fail
14085,1,True,4,2,6,2,2,fail
14086,1,True,2,1,3,1,1,pass
14087,1,True,3,3,6,3,2,fail
14104,2,True,8484,4793,13277,238,12,pass
14105,1,True,1,1,2,1,1,pass
14106,1,True,2,2,4,1,1,fail
14107,1,True,478,164,642,30,6,pass
14119,1,True,8,8,16,1,1,pass
14121,1,True,1,1,2,1,1,pass
14122,1,True,1,1,2,1,1,pass
14123,1,True,11,0,11,2,1,pass
14124,1,True,13,0,13,1,1,pass
14125,1,True,1,0,1,1,1,fail
14127,2,True,10,0,10,2,2,pass
14128,2,True,1,1,2,1,1,pass
14129,1,True,6,0,6,1,1,pass
14131,1,True,1,1,2,1,1,pass
14132,1,True,1,1,2,1,1,fail
14133,2,True,3,2,5,2,2,pass
14134,2,True,28,3,31,4,2,pass
14136,2,True,2,2,4,1,1,pass
14137,2,True,26,1,27,3,2,fail
14138,2,True,26,1,27,3,2,pass
14139,1,True,1,0,1,1,1,pass
14142,1,True,3,2,5,2,2,pass
14143,2,True,1,1,2,1,1,pass
14144,2,True,1,1,2,1,1,pass
14145,1,True,1,1,2,1,1,pass
14146,1,True,2,2,4,1,1,pass
14147,1,True,28,3,31,1,1,pass
14148,1,True,9,0,9,1,1,pass
14149,2,True,28,11,39,3,3,pass
14150,1,True,33,27,60,1,1,pass
14151,1,True,50,39,89,3,3,fail
14152,1,False,0,6,6,1,1,pass
14153,1,False,1,1,2,1,1,pass
14154,1,False,44,16,60,17,5,pass
14156,2,True,167,57,224,12,3,pass
14157,1,True,9,12,21,1,1,pass
14158,1,True,54,19,73,3,1,fail
14159,2,True,20,7,27,3,1,fail
14161,2,True,20,7,27,3,1,fail
14162,1,True,3,5,8,4,3,fail
14165,2,True,0,6,6,1,1,fail
14166,2,True,6250,330,6580,131,11,fail
14167,2,True,19,0,19,1,1,fail
14168,2,True,6256,341,6597,130,11,fail
14169,2,True,1,1,2,1,1,pass
14170,2,True,105,28,133,9,4,fail
14171,2,True,105,28,133,9,4,pass
14172,2,True,8,7,15,4,3,pass
14173,2,True,0,0,0,0,0,pass
14177,2,True,0,0,0,0,0,fail
14178,2,True,8,7,15,4,3,pass
14179,1,True,9,0,9,3,2,fail
14180,1,True,1,1,2,1,1,pass
14181,1,True,1,1,2,1,1,fail
14182,1,True,3,3,6,2,1,fail
14184,2,True,5652,3,5655,22,5,pass
14185,2,True,0,0,0,0,0,pass
14186,2,True,20,27,47,2,2,pass
14187,2,True,0,0,0,0,0,pass
14188,2,True,61,39,100,4,2,pass
14189,1,True,15,0,15,1,1,pass
14190,1,True,2,2,4,1,1,pass
14192,2,True,1,1,2,1,1,pass
14195,1,True,2,2,4,1,1,fail
14196,2,True,1,1,2,1,1,fail
14198,2,True,1,1,2,1,1,fail
14199,1,True,5637,3,5640,21,4,fail
14200,2,True,1,1,2,1,1,fail
14201,2,True,1,1,2,1,1,fail
14202,2,True,1,1,2,1,1,pass
14203,1,True,20,27,47,2,2,fail
14204,1,True,8,6,14,1,1,fail
14205,1,True,1,1,2,1,1,pass
14206,1,True,1,1,2,1,1,fail
14209,2,True,84,24,108,4,2,pass
14210,1,True,12,4,16,1,1,pass
14211,2,True,31,4,35,3,2,fail
14213,2,True,31,4,35,3,2,fail
14214,2,True,31,4,35,3,2,pass
14215,2,True,15,5,20,5,3,fail
14216,2,True,0,0,0,0,0,fail
14217,2,True,7,2,9,3,3,pass
14218,1,True,69,20,89,3,2,fail
14219,2,True,0,0,0,0,0,pass
14221,2,True,0,0,0,0,0,fail
14222,1,True,3,3,6,1,1,fail
14223,1,True,11,6,17,3,3,fail
14224,2,True,7,3,10,1,1,pass
14225,1,True,31,4,35,3,2,pass
14226,1,True,7,3,10,1,1,pass
14227,2,True,2,1,3,2,2,pass
14228,1,True,1,0,1,1,1,fail
14229,2,True,42,3,45,7,3,pass
14230,2,True,41,3,44,6,3,pass
14231,1,True,17,1,18,5,3,pass
14233,2,False,15169,5128,20297,300,21,pass
14235,1,True,1,1,2,1,1,fail
14236,1,False,1,1,2,1,1,pass
14237,1,False,1,1,2,1,1,pass
14238,1,False,218,195,413,78,8,pass
14239,2,True,27,13,40,6,2,pass
14240,2,True,27,13,40,6,2,pass
14241,1,True,0,6,6,1,1,fail
14242,1,True,19,0,19,1,1,pass
14243,1,True,0,1,1,1,1,pass
14244,2,True,0,0,0,0,0,fail
14245,2,True,14991,4994,19985,299,19,pass
14246,1,True,28,13,41,6,2,fail
14247,1,True,2,2,4,2,2,pass
14248,1,True,29,14,43,7,2,fail
14252,1,True,1,0,1,1,1,fail
14253,1,True,77,73,150,5,1,fail
14254,1,True,5,36,41,1,1,fail
14255,1,True,5,4,9,2,1,fail
14256,1,True,3,1,4,1,1,fail
14257,1,True,130,20,150,21,4,fail
14282,2,True,3,3,6,2,1,fail
14283,1,True,3,3,6,2,1,fail
14284,2,True,16,16,32,4,1,fail
14285,1,True,16,16,32,4,1,fail
14286,2,True,3,0,3,2,2,fail
14287,1,True,1,0,1,1,1,pass
14289,1,True,4,2,6,1,1,pass
14290,1,True,4,2,6,2,1,pass
14292,1,True,2,2,4,1,1,pass
14293,1,True,0,12,12,3,1,pass
14294,1,True,1,0,1,1,1,pass
14300,1,False,2,2,4,1,1,pass
14301,1,True,5,5,10,4,3,pass
14303,2,True,3,3,6,3,2,pass
14304,1,True,3,3,6,3,2,pass
14305,1,True,1,1,2,1,1,pass
14309,1,True,2,0,2,1,1,pass
14310,1,True,8,3,11,3,2,pass
14311,1,False,2,1,3,1,1,pass
14312,1,True,3,6,9,3,2,pass
14333,2,True,32,0,32,1,1,fail
14334,1,True,7,7,14,1,1,pass
14335,1,True,32,0,32,1,1,pass
14336,2,True,1,1,2,1,1,fail
14337,1,True,1,1,2,1,1,pass
14338,1,False,1,1,2,1,1,fail
14339,1,False,1,1,2,1,1,fail
14340,1,False,2,2,4,1,1,fail
14341,1,False,2,2,4,1,1,fail
14342,1,False,5,1,6,2,1,fail
14343,1,False,1,1,2,1,1,fail
14344,2,True,19,8,27,1,1,fail
14345,1,False,1,1,2,1,1,fail
14346,1,False,21,0,21,1,1,fail
14347,1,False,16,0,16,2,1,fail
14348,2,True,9,6,15,3,2,pass
14349,2,True,3,3,6,2,2,pass
14350,1,True,1,0,1,1,1,pass
14351,1,True,8,6,14,2,1,pass
14352,1,True,1,1,2,1,1,pass
14353,2,True,2,2,4,1,1,fail
14354,1,True,2,2,4,1,1,pass
14355,1,True,5,4,9,1,1,pass
14356,2,True,11116,2458,13574,152,31,pass
14357,2,True,19,5,24,1,1,pass
14358,2,True,9,3,12,5,3,pass
14359,1,True,2,2,4,1,1,pass
14360,2,True,5,2,7,2,2,pass
14361,2,True,5,2,7,4,3,pass
14362,2,True,2,1,3,2,2,pass
14363,2,True,3,1,4,2,2,pass
14364,2,True,2,0,2,1,1,pass
14365,2,True,1,1,2,1,1,pass
14366,2,True,1,1,2,1,1,pass
14367,1,True,1,1,2,1,1,pass
14368,1,True,2,0,2,1,1,pass
14369,1,True,2,1,3,2,2,pass
14370,1,True,3,0,3,1,1,pass
14371,1,True,2,2,4,1,1,pass
14372,2,True,11090,2452,13542,148,31,pass
14373,2,True,2,1,3,2,2,pass
14374,2,True,11244,2479,13723,156,33,pass
14375,2,True,384,42,426,17,7,pass
14376,1,True,128,42,170,9,3,pass
14383,2,True,10739,2444,13183,130,24,pass
14384,1,True,0,2658,2658,3,3,pass
14410,1,True,18,8,26,1,1,fail
14411,2,True,1,1,2,1,1,pass
14412,1,True,1,1,2,1,1,pass
14413,1,True,19,5,24,1,1,pass
14414,2,True,63,7,70,3,2,pass
14415,2,True,91,19,110,9,3,pass
14416,2,True,22,5,27,2,2,pass
14417,2,True,130,33,163,14,7,pass
14418,2,True,69,14,83,7,2,pass
14419,2,True,2,2,4,2,2,pass
14420,1,True,3,3,6,1,1,pass
14424,2,True,2,2,4,2,2,pass
14425,1,True,2,2,4,2,2,pass
14426,1,True,1,5,6,1,1,pass
14427,1,True,5,4,9,3,2,fail
14428,1,True,1,1,2,1,1,fail
14429,1,True,2,1,3,1,1,fail
14430,1,True,8,2,10,4,2,fail
14431,1,True,28,33,61,5,2,fail
14432,1,True,1,0,1,1,1,pass
14433,1,True,1,1,2,1,1,pass
14434,2,True,145,28,173,13,7,fail
14435,2,True,8,6,14,1,1,pass
14436,2,True,51,11,62,5,5,pass
14437,1,False,22,8,30,3,3,pass
14438,2,True,5,3,8,1,1,pass
14439,2,True,110,11,121,11,6,pass
14440,2,True,24,0,24,2,2,pass
14441,2,True,148,11,159,12,5,pass
14442,1,True,8,6,14,1,1,pass
14443,2,True,86,11,97,9,5,pass
14444,1,True,3,5,8,1,1,pass
14445,1,True,22,6,28,1,1,pass
14446,2,True,13,5,18,3,2,fail
14447,1,True,1,0,1,1,1,pass
14448,1,True,12,5,17,2,1,pass
14449,2,True,9,5,14,2,2,pass
14450,2,True,64,1,65,4,3,pass
14451,2,True,2,0,2,1,1,pass
14452,2,True,1,0,1,1,1,pass
14453,1,False,1,0,1,1,1,pass
14454,2,True,61,1,62,2,1,pass
14455,2,True,1,1,2,1,1,pass
14456,2,True,60,0,60,1,1,pass
14457,2,True,60,0,60,1,1,pass
14458,1,True,3,2,5,1,1,pass
14459,1,True,21,5,26,2,2,pass
14460,1,True,8,4,12,1,1,pass
14463,2,True,4,0,4,2,2,pass
14464,1,True,1,1,2,1,1,pass
14465,1,True,22,0,22,1,1,fail
14471,2,True,4,0,4,2,2,pass
14472,1,True,4,8,12,1,1,pass
14473,1,True,47,44,91,1,1,pass
14474,1,True,39,22,61,1,1,pass
14475,1,True,3,2,5,1,1,fail
14476,1,True,1,1,2,1,1,pass
14477,2,True,92,1,93,7,4,pass
14478,2,True,62,0,62,4,3,pass
14479,1,True,2,1,3,1,1,pass
14480,1,False,1,0,1,1,1,pass
14481,2,True,3,0,3,1,1,pass
14482,1,True,2,2,4,1,1,pass
14483,1,True,2,3,5,1,1,pass
14484,2,True,76,14,90,5,2,fail
14485,2,True,1288,474,1762,49,14,pass
14486,1,True,3,1,4,1,1,pass
14487,2,True,1289,475,1764,50,15,pass
14488,2,True,58,0,58,2,1,pass
14489,1,True,26,2,28,2,1,pass
14490,1,True,2,0,2,1,1,pass
14491,1,True,1,1,2,1,1,fail
14495,1,True,1,1,2,1,1,pass
14496,1,True,10,0,10,2,2,pass
14497,2,True,30,1,31,3,2,pass
14498,1,True,30,1,31,3,2,pass
14499,1,True,63,1,64,2,1,fail
14500,1,True,5,3,8,1,1,pass
14501,1,True,2,1,3,1,1,pass
14502,1,True,1,1,2,1,1,pass
14503,2,True,16,1,17,3,2,pass
14504,2,True,29,0,29,1,1,pass
14505,2,True,29,0,29,1,1,pass
14506,2,True,261,110,371,13,7,pass
14507,1,True,5,4,9,1,1,pass
14508,1,True,1,0,1,1,1,pass
14510,1,False,1,0,1,1,1,pass
14511,2,True,153,2,155,3,2,pass
14512,1,True,1,1,2,1,1,pass
14515,2,True,7,2,9,2,2,pass
14516,1,True,1,0,1,1,1,pass
14517,1,True,6,2,8,1,1,pass
14518,2,True,89,101,190,6,2,pass
14519,1,True,27,32,59,2,2,pass
14536,2,True,11,5,16,3,2,pass
14537,1,True,28,0,28,1,1,pass
14538,2,True,897,365,1262,33,11,pass
14539,2,True,96,38,134,6,4,pass
14540,2,True,837,330,1167,29,10,pass
14541,2,True,760,316,1076,23,9,pass
14542,2,True,41,11,52,5,3,pass
14543,2,True,40,10,50,4,2,pass
14544,1,True,2,0,2,1,1,pass
14545,1,True,2,0,2,1,1,pass
14546,1,True,1,1,2,1,1,pass
14547,1,True,1,0,1,1,1,pass
14548,1,True,7,21,28,1,1,pass
14551,2,True,1,1,2,1,1,pass
14552,1,True,1,1,2,1,1,pass
14553,2,True,1,0,1,1,1,pass
14555,1,True,9,5,14,2,1,pass
14556,1,True,3,3,6,2,1,pass
14557,1,True,1,2,3,1,1,fail
14558,1,True,163,88,251,14,6,fail
14612,2,True,36,3,39,4,2,pass
14613,1,True,2,0,2,1,1,pass
14614,1,True,7,6,13,3,1,pass
14618,1,True,2,2,4,2,2,pass
14619,1,True,2,2,4,2,2,fail
14620,1,True,2,0,2,1,1,fail
14621,1,True,3,1,4,1,1,fail
14622,1,True,26,9,35,4,3,fail
14623,1,True,2,2,4,2,2,fail
14624,1,True,55,31,86,3,3,fail
14626,1,False,2,0,2,2,2,pass
14627,2,True,37,10,47,1,1,pass
14628,1,True,11,3,14,1,1,pass
14631,1,False,1,0,1,1,1,pass
14632,2,True,1,1,2,1,1,pass
14633,2,True,38,14,52,3,1,pass
14634,2,True,38,14,52,3,1,pass
14635,1,True,4,3,7,1,1,pass
14636,1,True,1,1,2,1,1,fail
14637,1,True,37,14,51,3,1,fail
14638,2,True,44,46,90,2,1,fail
14639,2,True,34,6,40,6,4,pass
14640,2,True,34,6,40,6,4,pass
14641,1,True,34,6,40,6,4,pass
14642,1,True,1,0,1,1,1,pass
14643,1,True,30,31,61,1,1,fail
14644,1,True,16,18,34,2,1,fail
14645,2,True,2,1,3,2,2,pass
14646,1,True,2,1,3,2,2,pass
14647,2,True,1,1,2,1,1,pass
14648,2,True,132,32,164,2,1,pass
14649,2,True,1,1,2,1,1,pass
14650,1,True,1,1,2,1,1,pass
14651,2,True,131,31,162,2,1,pass
14652,1,True,1,1,2,1,1,pass
14653,2,True,251,61,312,21,12,pass
14654,2,True,2,3,5,1,1,pass
14655,1,True,2,3,5,1,1,pass
14657,2,True,4,1,5,1,1,pass
14658,2,True,0,4,4,1,1,pass
14659,2,True,0,4,4,1,1,pass
14660,1,True,0,4,4,1,1,pass
14661,1,True,4,1,5,1,1,pass
14662,2,True,7,0,7,2,2,pass
14663,1,True,7,0,7,2,2,pass
14664,2,True,1,1,2,1,1,pass
14665,1,True,1,1,2,1,1,pass
14666,2,True,1,1,2,1,1,pass
14667,1,True,1,1,2,1,1,pass
14668,1,False,57,1,58,2,2,pass
14672,2,True,60,10,70,2,1,pass
14673,1,True,2,2,4,1,1,pass
14674,1,True,37,14,51,1,1,pass
14676,2,True,11,0,11,1,1,pass
14677,2,True,91,37,128,9,7,pass
14678,1,True,11,0,11,1,1,pass
14679,2,True,91,37,128,9,7,pass
14680,1,True,8,2,10,1,1,pass
14681,2,True,0,0,0,0,0,pass
14682,2,True,0,0,0,0,0,pass
14683,1,True,1,2,3,1,1,pass
14684,1,True,131,31,162,2,1,pass
14685,2,True,0,11,11,1,1,pass
14686,1,True,0,11,11,1,1,fail
14687,2,True,11,0,11,1,1,pass
14688,2,True,161,147,308,19,5,pass
14689,1,True,1,1,2,1,1,pass
14690,2,True,64,30,94,7,3,fail
14691,2,True,64,30,94,7,3,pass
14692,2,True,64,30,94,7,3,pass
14693,2,True,3,3,6,3,1,pass
14694,1,True,2,0,2,1,1,pass
14696,2,True,97,117,214,12,4,pass
14697,1,True,0,2,2,1,1,pass
14698,1,True,40,29,69,3,2,pass
14699,1,True,42,0,42,1,1,fail
14702,2,True,3,3,6,3,1,pass
14703,1,True,3,3,6,3,1,pass
14704,1,True,2,3,5,1,1,pass
14705,2,True,13,4,17,3,2,pass
14706,1,True,2,0,2,1,1,pass
14708,2,True,81,110,191,6,3,pass
14709,1,True,81,110,191,6,3,pass
14710,1,True,9,1,10,1,1,fail
14712,2,True,664,345,1009,33,7,pass
14713,2,True,0,5,5,1,1,pass
14714,1,True,0,5,5,1,1,pass
14715,2,True,211,97,308,6,3,pass
14716,1,True,1,1,2,1,1,pass
14717,1,True,211,97,308,6,3,pass
14718,2,True,1,1,2,1,1,pass
14719,1,True,1,1,2,1,1,pass
14720,2,True,312,215,527,25,4,pass
14721,1,True,156,162,318,12,3,pass
14723,2,True,140,27,167,1,1,pass
14724,1,True,140,27,167,1,1,fail
14725,2,True,1,1,2,1,1,pass
14726,2,True,1,1,2,1,1,pass
14727,1,True,1,1,2,1,1,pass
14728,1,True,11,0,11,1,1,pass
14729,2,True,5,7,12,1,1,pass
14730,1,True,5,7,12,1,1,pass
14732,2,True,66,11,77,5,2,pass
14733,1,True,6,3,9,1,1,pass
14735,2,True,2,0,2,2,1,pass
14736,2,True,12703,8341,21044,300,42,pass
14737,1,True,2,0,2,2,1,fail
14738,2,True,1,1,2,1,1,pass
14739,1,True,1,1,2,1,1,pass
14740,2,True,11,4,15,1,1,pass
14741,2,True,22,2,24,2,2,pass
14742,1,False,4,2,6,1,1,pass
14743,2,False,122,2189,2311,50,17,pass
14745,1,True,11,4,15,1,1,pass
14746,2,True,22,2040,2062,40,15,pass
14747,1,True,2,0,2,1,1,pass
14750,2,True,54,135,189,8,3,pass
14751,1,True,2,1,3,1,1,pass
14752,2,True,1,2,3,1,1,pass
14753,2,True,1,2,3,1,1,pass
14754,1,True,1,1,2,1,1,pass
14755,1,True,9,21,30,2,1,fail
14756,1,True,1,1,2,1,1,fail
14759,1,True,39,38,77,1,1,fail
14760,1,True,1,2,3,1,1,pass
14761,2,True,35,9,44,4,2,pass
14762,1,True,29,9,38,3,2,fail
14764,2,True,10,3,13,1,1,pass
14765,1,True,10,3,13,1,1,fail
14766,1,False,1,0,1,1,1,fail
14768,1,False,48,8,56,1,1,pass
14769,2,True,0,0,0,1,1,fail
14770,2,True,1,1,2,1,1,fail
14771,2,True,4,287,291,2,2,fail
14772,2,True,34,4,38,1,1,fail
14773,2,True,874,758,1632,18,10,fail
14774,2,True,722,732,1454,15,8,fail
14775,2,True,11,1,12,1,1,fail
14776,2,True,11,1,12,1,1,fail
14777,1,True,0,114,114,1,1,fail
14778,1,True,321,294,615,7,4,fail
14779,1,True,10,2,12,1,1,fail
14784,1,True,1,1,2,1,1,fail
14785,1,True,6,3,9,1,1,fail
14786,1,True,86,82,168,4,3,fail
14787,1,True,1,1,2,1,1,fail
14788,1,True,52,58,110,1,1,fail
14789,1,True,233,172,405,1,1,fail
14790,1,False,2,0,2,1,1,fail
14792,1,False,4,3,7,1,1,fail
14793,2,False,79,27,106,3,1,fail
14795,1,True,34,4,38,1,1,fail
14797,2,True,79,27,106,3,1,fail
14798,1,True,29,2,31,2,1,fail
14799,1,True,1,1,2,1,1,fail
14800,1,True,1,2,3,1,1,fail
14801,1,True,49,23,72,1,1,fail
14802,1,False,1,1,2,1,1,fail
14808,1,False,66,59,125,2,2,fail
14809,1,False,5,4,9,2,2,fail
14810,1,False,1,1,2,1,1,fail
14811,1,False,2,0,2,1,1,fail
14813,1,True,1,4,5,1,1,pass
14816,1,False,2,2,4,1,1,pass
14817,1,False,289,1,290,3,2,pass
14824,2,True,56,47,103,8,3,pass
14825,1,True,24,19,43,3,2,pass
14826,1,True,2,4,6,1,1,pass
14827,1,True,5,1,6,1,1,fail
14829,1,True,1,6,7,1,1,fail
14830,2,True,277,189,466,18,11,pass
14831,1,False,89,1,90,11,5,pass
14833,2,True,10,17,27,8,4,pass
14834,1,True,2,1,3,1,1,pass
14839,1,True,10,17,27,8,4,pass
14840,2,True,1,0,1,1,1,pass
14841,2,True,153,81,234,9,5,fail
14842,2,True,153,81,234,9,5,fail
14843,1,True,2,2,4,2,2,pass
14844,1,True,16,6,22,2,2,pass
14845,2,True,6,3,9,1,1,fail
14847,1,True,6,3,9,1,1,fail
14848,1,True,44,47,91,2,2,fail
14849,1,True,7,7,14,2,2,fail
14851,1,True,2,1,3,1,1,fail
14852,1,True,34,25,59,3,2,fail
14853,1,True,117,24,141,5,3,fail
14854,2,True,83,23,106,3,3,pass
14856,2,True,83,23,106,3,3,pass
14857,1,True,1,0,1,1,1,pass
14858,2,True,120,64,184,9,3,pass
14859,2,True,118,63,181,8,3,pass
14860,2,True,97,60,157,4,1,fail
14864,1,True,97,60,157,4,1,fail
14865,1,True,1,0,1,1,1,fail
14868,1,True,1,1,2,1,1,pass
14869,2,True,2,1,3,1,1,pass
14870,1,True,2,1,3,1,1,pass
14871,2,True,230,119,349,7,3,fail
14872,2,True,230,119,349,7,3,pass
14873,1,True,7,1,8,1,1,fail
14874,1,True,2,0,2,2,2,fail
14875,1,True,6,6,12,1,1,fail
14878,2,True,49,11,60,10,5,fail
14879,2,True,49,11,60,10,5,fail
14880,2,True,49,11,60,10,5,pass
14881,1,True,0,1,1,1,1,pass
14882,1,True,2,1,3,1,1,fail
14883,1,True,1,1,2,1,1,fail
14884,2,True,148,19,167,16,6,fail
14886,2,True,148,19,167,16,6,fail
14887,2,True,350,111,461,45,9,fail
14888,2,True,242,95,337,28,6,fail
14889,2,True,12,4,16,1,1,fail
14891,2,True,137,16,153,15,6,pass
14892,1,True,5,7,12,1,1,pass
14893,2,True,67,26,93,2,1,fail
14894,2,True,67,26,93,2,1,fail
14895,2,True,91,74,165,12,2,pass
14896,2,True,67,26,93,2,1,fail
14898,1,True,2,2,4,1,1,fail
14899,2,True,1,1,2,1,1,pass
14900,1,True,12,1,13,3,3,fail
14903,2,True,1,1,2,1,1,pass
14905,2,True,24,48,72,11,2,fail
14906,2,True,23,47,70,10,2,fail
14907,1,True,12,4,16,1,1,pass
14908,1,True,67,26,93,2,1,pass
14909,2,True,1,1,2,1,1,pass
14910,2,True,1,1,2,1,1,pass
14911,1,True,0,1,1,1,1,pass
14912,1,True,1,1,2,1,1,fail
14913,1,True,1,0,1,1,1,pass
14914,1,True,1,1,2,1,1,pass
14915,1,True,1,1,2,1,1,pass
14916,1,True,10,5,15,1,1,pass
14917,1,True,4,3,7,1,1,pass
14918,1,True,10,30,40,6,1,fail
14919,1,True,11,16,27,4,2,fail
14920,1,True,5,15,20,3,3,pass
14923,2,True,2,1,3,2,2,pass
14924,1,True,5,3,8,1,1,pass
14925,1,True,4,1,5,1,1,fail
14926,2,True,8,4,12,4,1,fail
14927,1,True,2,1,3,2,2,fail
14928,1,True,1,1,2,1,1,fail
14929,1,True,5,4,9,2,1,fail
14932,1,True,2,2,4,1,1,fail
14933,1,True,1,1,2,1,1,pass
14934,2,True,8,4,12,4,1,fail
14935,2,True,8,4,12,4,1,pass
14936,2,True,25,4,29,3,2,fail
14937,1,True,25,4,29,3,2,fail
14938,1,True,2,2,4,2,2,fail
14940,1,True,4,1,5,1,1,pass
14944,2,True,1,1,2,1,1,fail
14945,2,True,534,269,803,92,12,fail
14946,2,True,12,6,18,6,4,pass
14947,1,True,2,2,4,1,1,fail
14949,1,False,9,6,15,2,2,pass
14950,2,True,3,3,6,1,1,fail
14952,2,True,34,1,35,3,2,pass
14953,1,True,3,3,6,1,1,pass
14954,1,True,33,0,33,2,2,pass
14956,1,False,2,0,2,2,2,pass
14957,1,False,2,0,2,2,2,pass
14958,2,True,5,1,6,1,1,fail
14959,2,True,311,236,547,76,10,fail
14960,2,True,35,2,37,2,1,pass
14961,2,True,40,22,62,11,5,pass
14962,2,True,1,0,1,1,1,pass
14963,1,True,1,0,1,1,1,pass
14964,1,True,221,121,342,5,1,pass
14965,2,True,5,3,8,5,4,pass
14966,2,True,0,0,0,0,0,fail
14967,2,True,34,19,53,5,3,pass
14968,1,True,5,3,8,5,4,fail
14969,1,True,34,19,53,5,3,pass
14970,2,True,933,553,1486,114,14,pass
14971,1,True,2,1,3,1,1,fail
14973,1,False,0,4,4,4,1,pass
14975,1,False,0,110,110,1,1,pass
14976,1,False,188,74,262,52,6,pass
14980,2,True,34,10,44,4,2,pass
14981,1,True,23,14,37,4,2,pass
14982,1,True,0,1,1,1,1,pass
14983,1,True,18,9,27,2,1,pass
14984,1,True,2,2,4,1,1,pass
14985,1,True,7,1,8,1,1,pass
14986,1,True,1,8,9,1,1,fail
14987,1,True,12,4,16,1,1,fail
14988,2,True,28,49,77,6,2,pass
14989,1,True,5,1,6,1,1,pass
14990,1,True,12,8,20,2,1,pass
14993,2,True,177,37,214,11,3,pass
14994,1,True,2,2,4,2,1,pass
14995,1,True,1,1,2,1,1,pass
14996,1,True,1,1,2,1,1,fail
14997,1,True,3,2,5,2,1,fail
14998,1,True,11,9,20,5,2,fail
14999,1,True,7,25,32,1,1,fail
15002,1,True,23,0,23,1,1,pass
15006,1,True,0,7,7,1,1,pass
15007,1,True,1,1,2,1,1,pass
15008,1,True,56,22,78,3,1,fail
15011,1,False,17,17,34,2,2,pass
15012,2,True,516,308,824,49,8,pass
15013,1,True,19,16,35,3,1,pass
15023,2,True,7,1,8,2,2,pass
15024,1,True,1,0,1,1,1,fail
15025,2,True,58,6,64,9,6,pass
15026,2,True,27,0,27,4,4,pass
15027,1,True,2,0,2,2,2,fail
15029,2,False,19,2,21,3,2,pass
15036,1,True,6,1,7,1,1,fail
15038,2,True,33,13,46,3,2,pass
15039,2,True,38,43,81,3,1,fail
15040,2,True,38,43,81,3,1,pass
15041,1,True,3,3,6,3,2,fail
15042,2,True,450,18,468,57,13,fail
15044,1,True,0,4,4,2,1,pass
15047,1,True,19,10,29,1,1,fail
15048,1,True,1,0,1,1,1,pass
15050,1,True,1,1,2,1,1,pass
15051,1,True,87,127,214,4,4,fail
15054,2,True,5436,2208,7644,129,14,pass
15055,1,True,66,4,70,4,3,pass
15060,2,True,4,2,6,1,1,pass
15061,1,True,2,2,4,1,1,pass
15062,1,True,1,1,2,1,1,pass
15063,1,True,4,2,6,1,1,fail
15064,2,True,376,116,492,15,5,pass
15065,1,True,35,14,49,3,1,pass
15067,1,True,94,96,190,7,4,pass
15069,2,True,10,11,21,1,1,pass
15070,2,True,125,79,204,9,2,fail
15071,2,True,1,1,2,1,1,pass
15073,2,True,124,78,202,8,1,pass
15074,1,True,4,4,8,1,1,pass
15075,1,True,14,4,18,1,1,pass
15076,1,True,1,1,2,1,1,pass
15084,2,True,11,17,28,1,1,pass
15085,2,True,11,17,28,1,1,pass
15086,1,True,10,11,21,1,1,pass
15087,2,True,389,122,511,16,1,pass
15088,2,True,2,0,2,1,1,fail
15090,2,True,9,1,10,1,1,pass
15091,2,True,383,122,505,14,1,pass
15092,1,True,5,1,6,1,1,fail
15093,2,True,378,121,499,14,1,pass
15094,2,True,378,121,499,14,1,pass
15095,1,True,9,40,49,1,1,pass
15096,1,True,1,1,2,1,1,fail
15097,1,True,15,11,26,1,1,fail
15098,1,True,1,1,2,1,1,fail
15099,1,True,1,1,2,1,1,fail
15100,1,True,30,12,42,6,1,fail
15102,1,True,3,6,9,1,1,pass
15106,1,True,9,11,20,1,1,fail
15107,1,True,2,2,4,1,1,fail
15108,1,True,98,49,147,2,1,fail
15109,1,True,67,59,126,2,1,fail
15110,1,True,2,1,3,1,1,fail
15111,1,True,116,82,198,6,1,fail
15112,1,True,102,25,127,3,1,fail
15113,1,True,15,0,15,1,1,fail
15114,1,True,38,0,38,2,1,fail
15115,1,True,2,0,2,1,1,fail
15116,1,True,1,0,1,1,1,pass
15117,1,True,9,3,12,2,1,fail
15118,1,True,9,7,16,1,1,fail
15120,1,True,11,17,28,1,1,fail
15121,1,False,5,1,6,1,1,pass
15122,2,True,1,1,2,1,1,pass
15123,2,True,1,1,2,1,1,pass
15124,2,True,1715,612,2327,37,9,pass
15125,2,True,1260,395,1655,23,7,pass
15126,2,True,1260,395,1655,23,7,pass
15127,2,True,118,136,254,2,1,fail
15128,1,True,0,0,0,1,1,pass
15129,1,True,1,2,3,1,1,fail
15130,1,True,0,893,893,1,1,fail
15140,2,True,118,136,254,2,1,fail
15141,1,True,5,1,6,1,1,fail
15142,1,True,4,3,7,2,1,pass
15147,2,True,62,58,120,4,2,fail
15148,2,True,265,20,285,10,2,pass
15149,2,True,265,20,285,10,2,fail
15150,1,True,265,20,285,10,2,pass
15151,2,True,13,7,20,2,1,fail
15152,2,True,13,7,20,2,1,fail
15153,2,True,6,5,11,3,2,fail
15154,2,True,6,5,11,3,2,pass
15155,2,True,1,1,2,1,1,fail
15159,1,True,1,1,2,1,1,fail
15160,2,True,3,3,6,1,1,pass
15161,1,True,62,58,120,4,2,fail
15162,1,True,1,1,2,1,1,pass
15163,1,True,2,1,3,1,1,pass
15164,1,True,9,4,13,1,1,pass
15165,1,True,1,1,2,1,1,fail
15166,1,True,3,3,6,1,1,pass
15167,1,True,3,2,5,1,1,pass
15168,2,True,1,0,1,1,1,fail
15169,1,True,1,0,1,1,1,fail
15170,2,True,8,0,8,1,1,fail
15171,2,True,122,32,154,7,3,fail
15172,2,True,53,10,63,4,3,fail
15173,2,True,43,15,58,3,1,pass
15174,2,True,69,22,91,4,1,pass
15175,2,True,43,15,58,3,1,pass
15176,2,True,26,7,33,2,1,pass
15177,1,True,0,0,0,1,1,fail
15178,1,True,43,15,58,3,1,fail
15179,2,True,26,7,33,2,1,fail
15180,1,True,6,7,13,1,1,pass
15182,1,True,1,1,2,1,1,fail
15183,2,True,336,156,492,12,2,pass
15184,2,True,336,156,492,12,2,pass
15185,2,True,263,125,388,7,2,fail
15188,1,True,2,4,6,1,1,pass
15189,1,True,2,1,3,1,1,fail
15190,1,True,32,12,44,3,1,fail
15191,1,True,51,17,68,1,1,fail
15192,1,True,9,11,20,2,2,fail
15194,1,True,19,15,34,2,2,fail
15195,1,True,1,1,2,1,1,fail
15196,1,True,44,32,76,2,2,fail
15199,1,True,59,49,108,2,1,fail
15200,1,True,4,2,6,2,1,fail
15201,2,True,73,31,104,5,2,fail
15205,1,True,23,14,37,4,2,pass
15206,1,True,52,19,71,3,1,fail
15207,1,True,29,3,32,3,2,fail
15209,1,True,8,0,8,1,1,fail
15210,2,True,2,2,4,1,1,fail
15211,1,True,2,2,4,1,1,pass
15212,2,True,26497,415,26912,74,11,pass
15213,1,True,17,24,41,2,2,pass
15214,1,True,20,3,23,2,2,fail
15215,1,True,2,1,3,1,1,fail
15216,1,True,3,2,5,2,1,fail
15230,2,True,10422,117360,127782,300,10,fail
15231,1,True,0,25,25,1,1,fail
15232,1,True,37,25,62,2,1,pass
15233,1,True,1,1,2,1,1,pass
15234,1,True,79,24,103,4,2,fail
15235,1,True,38,4,42,1,1,fail
15256,2,True,406,325,731,27,5,pass
15257,2,True,235,62,297,15,7,pass
15258,2,True,16,1,17,2,2,pass
15260,2,True,154,52,206,5,1,fail
15262,2,True,2,2,4,1,1,fail
15263,2,True,12,6,18,4,3,fail
15264,2,True,201,24,225,6,3,fail
15265,2,True,51,1,52,3,2,fail
15266,2,True,201,24,225,6,3,pass
15267,2,True,51,1,52,3,2,pass
15268,1,True,2,2,4,1,1,pass
15269,1,True,51,1,52,3,2,pass
15270,2,True,150,23,173,3,2,pass
15271,2,True,171,29,200,8,4,pass
15272,2,True,150,23,173,3,2,pass
15273,2,True,262,54,316,13,5,pass
15274,2,True,13,6,19,3,1,pass
15275,2,True,11,0,11,1,1,pass
15277,1,True,0,1,1,1,1,fail
15278,1,True,0,0,0,0,0,fail
15279,2,True,21,6,27,5,2,fail
15280,2,True,11,0,11,1,1,fail
15282,1,True,1,26,27,2,2,fail
15287,1,False,2,6,8,2,1,pass
15288,1,False,2,2,4,2,1,fail
15289,1,False,1,1,2,1,1,fail
15290,1,False,1,1,2,1,1,fail
15291,1,False,1,1,2,1,1,fail
15292,1,False,1,1,2,1,1,fail
15293,2,True,8,0,8,2,1,pass
15294,2,True,8,0,8,2,1,fail
15295,1,False,8,0,8,2,1,fail
15296,1,True,11,0,11,1,1,pass
15297,1,True,39,25,64,4,2,pass
15298,1,True,18,18,36,7,3,fail
15299,1,True,227,62,289,15,2,fail
15304,2,True,39,3,42,3,1,fail
15305,2,True,39,3,42,3,1,pass
15306,2,True,2,0,2,1,1,pass
15307,2,True,397,4477,4874,26,6,pass
15308,2,True,37,3,40,3,1,pass
15309,1,True,131,0,131,1,1,fail
15311,1,True,107,85,192,3,1,fail
15313,2,True,226,4482,4708,11,6,fail
15315,1,False,0,25,25,1,1,fail
15318,1,False,1,3,4,1,1,fail
15319,1,False,2,2,4,2,1,fail
15320,2,True,202,20,222,4,2,fail
15321,2,True,202,20,222,4,2,fail
15322,1,True,202,20,222,4,2,fail
15323,2,True,24,4,28,5,3,pass
15324,2,True,145,4445,4590,14,7,pass
15325,2,True,1,1,2,1,1,fail
15326,2,True,8,3,11,3,2,fail
15327,2,True,2,2,4,2,1,pass
15328,2,True,21,1,22,3,2,fail
15329,2,True,3,0,3,1,1,pass
15330,2,True,3,1,4,1,1,fail
15331,2,True,3,1,4,1,1,fail
15332,2,True,15,0,15,2,2,pass
15336,2,True,121,4441,4562,10,5,fail
15338,1,True,2,2,4,2,1,pass
15339,1,True,2,2,4,2,1,pass
15340,1,True,37,3,40,3,1,pass
15341,1,True,3,0,3,1,1,pass
15342,2,True,79,4439,4518,7,4,pass
15343,2,True,0,4433,4433,1,1,pass
15344,1,True,0,4433,4433,1,1,pass
15345,2,True,79,6,85,6,3,pass
15346,1,False,53,0,53,3,1,pass
15347,1,False,2,2,4,2,2,pass
15348,1,False,2,0,2,1,1,fail
15350,1,True,23,5,28,1,1,fail
15351,1,True,2,0,2,1,1,pass
15352,1,True,1,1,2,1,1,pass
15353,2,True,25,0,25,1,1,pass
15354,1,True,1,1,2,1,1,pass
15355,2,True,25,0,25,1,1,pass
15356,1,False,0,0,0,1,1,pass
15357,1,False,25,0,25,1,1,fail
15358,2,True,1,1,2,1,1,pass
15359,2,True,1,1,2,1,1,pass
15360,1,True,1,1,2,1,1,pass
15361,2,True,55,11,66,12,3,pass
15362,1,True,14,0,14,1,1,pass
15363,1,True,13,0,13,1,1,pass
15364,2,True,6,1,7,1,1,pass
15366,2,True,8,0,8,1,1,fail
15368,1,True,2,1,3,1,1,pass
15369,1,True,2,0,2,1,1,pass
15371,2,True,2,1,3,1,1,pass
15372,1,True,8,0,8,1,1,pass
15373,2,True,2,1,3,1,1,pass
15374,1,True,2,1,3,1,1,pass
15375,2,True,1,1,2,1,1,pass
15377,1,False,7,6,13,6,3,fail
15378,1,True,1,1,2,1,1,fail
15379,1,False,22,4,26,4,2,pass
15380,2,True,10,1,11,2,1,pass
15381,2,True,123,111,234,10,5,pass
15382,2,True,174,125,299,13,6,pass
15383,2,True,123,111,234,10,5,pass
15384,2,True,59,20,79,3,1,pass
15385,1,True,59,20,79,3,1,pass
15386,1,False,3,0,3,1,1,pass
15387,2,True,43,77,120,4,3,fail
15388,1,True,0,25,25,1,1,fail
15389,1,True,29,53,82,1,1,fail
15390,1,True,1,1,2,1,1,fail
15391,1,True,2,2,4,1,1,fail
15392,1,True,2,3,5,1,1,fail
15393,1,True,1,0,1,1,1,fail
15394,1,True,3,2,5,1,1,fail
15395,1,True,0,0,0,0,0,fail
15396,1,True,14,0,14,2,2,fail
15397,1,True,1,1,2,1,1,fail
15398,1,True,0,0,0,0,0,fail
15401,1,False,2,0,2,1,1,fail
15402,1,False,0,0,0,0,0,fail
15403,2,True,16,14,30,2,1,pass
15404,1,True,10,1,11,2,1,pass
15405,1,True,5,4,9,2,1,pass
15406,1,True,10,10,20,1,1,pass
15407,2,True,51,14,65,5,2,pass
15408,1,True,6,10,16,1,1,fail
15409,1,True,7,3,10,2,1,fail
15411,2,True,51,14,65,5,2,pass
15412,2,True,326,150,476,20,5,pass
15413,1,True,51,14,65,5,2,pass
15414,2,True,26,19,45,2,1,pass
15416,2,True,121,86,207,12,5,pass
15417,1,True,5,4,9,1,1,fail
15421,2,True,59,6,65,2,1,pass
15423,2,True,120,39,159,6,1,pass
15430,1,True,7,10,17,1,1,fail
15431,1,True,2,0,2,1,1,fail
15432,1,True,5,14,19,4,1,fail
15434,1,True,5,1,6,1,1,fail
15439,1,True,2,2,4,1,1,fail
15440,1,True,8,2,10,1,1,fail
15441,1,True,8,8,16,1,1,fail
15442,2,True,3,4,7,2,1,fail
15443,1,False,3,4,7,2,1,fail
15444,2,True,38,3,41,3,2,fail
15445,2,True,38,3,41,3,2,pass
15446,2,True,4065,86,4151,57,24,fail
15447,1,True,38,3,41,3,2,fail
15448,2,True,4,3,7,1,1,pass
15449,2,True,4000,68,4068,53,24,pass
15450,2,True,1,1,2,1,1,pass
15452,2,True,5,4,9,1,1,fail
15454,2,True,1,2,3,1,1,fail
15456,2,True,40,1,41,2,1,fail
15457,1,True,4,4,8,1,1,fail
15459,2,True,298,60,358,5,1,pass
15461,2,True,45,0,45,2,1,fail
15462,2,True,3610,0,3610,46,23,fail
15463,2,True,3610,0,3610,46,23,pass
15464,1,True,4,3,7,1,1,pass
15465,1,True,1,1,2,1,1,pass
15466,1,True,40,1,41,2,1,pass
15467,1,True,5,4,9,1,1,pass
15468,1,True,37,0,37,1,1,pass
15469,1,True,8,0,8,1,1,pass
15470,1,True,2,0,2,1,1,pass
15471,1,True,296,60,356,5,1,fail
15472,1,True,3610,0,3610,46,23,pass
15473,2,True,295,157,452,27,6,pass
15474,2,True,1,1,2,1,1,pass
15475,1,True,1,1,2,1,1,pass
15476,2,True,4,4,8,1,1,pass
15477,2,True,62,16,78,5,2,fail
15478,2,True,1,1,2,1,1,fail
15479,2,True,61,15,76,5,2,fail
15480,2,True,18,3,21,2,1,fail
15481,2,True,43,12,55,4,2,pass
15482,2,True,0,1,1,1,1,pass
15483,2,True,43,11,54,3,1,fail
15486,2,True,78135,24950,103085,300,17,fail
15487,1,True,4,4,8,1,1,pass
15488,1,True,1,1,2,1,1,pass
15489,2,True,194,125,319,17,4,pass
15490,1,True,1,1,2,1,1,fail
15491,1,True,4,1,5,1,1,pass
15492,1,True,40,1,41,2,1,fail
15494,1,False,12,0,12,1,1,pass
15496,2,True,181,125,306,15,3,pass
15497,1,True,150,13,163,12,2,pass
15498,1,True,2,1,3,1,1,pass
15499,1,True,28,110,138,1,1,pass
15500,1,True,11,6,17,1,1,pass
15501,2,True,24,3,27,2,2,fail
15502,1,True,96,28,124,4,1,fail
15503,2,True,24,3,27,2,2,fail
15504,1,False,24,3,27,2,2,pass
15505,2,True,2,2,4,2,2,fail
15506,1,False,2,2,4,2,2,pass
15507,2,True,165354,30288,195642,300,23,fail
15508,2,True,77919,24824,102743,300,15,pass
15509,2,True,2,2,4,1,1,pass
15510,2,True,6,4,10,3,3,fail
15511,2,True,4,3,7,1,1,pass
15512,2,True,2,1,3,2,2,fail
15513,2,True,2,1,3,2,2,fail
15514,1,True,2,1,3,2,2,fail
15515,1,True,4,3,7,1,1,pass
15516,1,True,2,2,4,1,1,pass
15518,2,True,30,0,30,2,1,pass
15520,1,True,24,0,24,1,1,fail
15522,2,True,3,0,3,1,1,pass
15523,2,True,69,16,85,6,3,fail
15524,2,True,45,13,58,4,2,fail
15525,1,True,45,13,58,4,2,fail
15526,2,False,0,0,0,0,0,pass
15527,1,False,12,4,16,3,2,pass
15528,1,False,2,2,4,1,1,pass
15529,1,False,15,2,17,3,2,fail
15531,1,False,16,12,28,3,2,pass
15532,1,False,2,3,5,1,1,fail
15533,2,True,77787,24786,102573,300,15,fail
15534,2,True,13,10,23,2,1,pass
15535,1,True,4,3,7,1,1,pass
15552,1,True,18,4,22,1,1,pass
15555,2,True,15,15,30,3,2,pass
15557,1,True,0,0,0,1,1,fail
15558,1,True,15,15,30,1,1,fail
15559,2,True,23,0,23,1,1,pass
15560,2,True,31,5,36,2,1,fail
15562,2,True,3,0,3,1,1,fail
15564,2,True,3,0,3,1,1,pass
15567,2,True,3,1,4,2,1,pass
15568,1,True,3,1,4,2,1,fail
15570,2,True,291,67,358,7,2,pass
15572,1,True,10,54,64,1,1,pass
15574,1,True,33,41,74,3,1,fail
15576,1,True,2,0,2,1,1,pass
15588,2,True,252,216,468,5,1,pass
15589,1,True,3,3,6,2,1,pass
15592,2,True,62,228,290,6,3,pass
15593,2,True,17,16,33,2,2,fail
15599,2,True,472,7340,7812,18,8,fail
15604,1,True,37,15,52,2,1,fail
15605,1,True,0,0,0,1,1,fail
15606,1,True,1,0,1,1,1,fail
15607,1,True,43,14,57,2,2,fail
15608,1,True,0,1,1,1,1,fail
15609,1,True,63,142,205,3,3,fail
15612,1,True,4,4,8,1,1,pass
15615,2,True,26,24,50,7,2,fail
15619,1,True,25,24,49,7,2,pass
15620,2,True,0,7300,7300,4,3,pass
15621,1,True,0,7300,7300,4,3,fail
15622,2,True,592,5,597,5,4,fail
15623,2,True,552,0,552,3,3,pass
15624,2,True,40,5,45,2,2,fail
15626,2,True,1735,18,1753,45,31,fail
15629,1,True,29,0,29,1,1,pass
15631,1,True,4,216,220,3,1,fail
15632,2,True,5,5,10,1,1,fail
15633,2,True,5,5,10,1,1,pass
15634,2,True,3354,1507,4861,62,31,pass
15635,2,True,1668,1,1669,39,28,pass
15636,2,True,1668,1,1669,39,28,pass
15637,2,True,30,7,37,4,2,fail
15638,2,True,36,12,48,5,2,fail
15639,2,True,30,7,37,4,2,fail
15640,2,True,7,5,12,2,2,fail
15642,2,True,6,5,11,1,1,fail
15643,2,True,6,5,11,1,1,fail
15644,2,True,6,5,11,1,1,pass
15645,2,True,13,0,13,1,1,fail
15646,1,True,17,10,27,2,1,fail
15647,1,True,5,5,10,1,1,fail
15648,1,True,1,1,2,1,1,fail
15649,1,True,4,0,4,2,1,fail
15653,2,True,13,0,13,1,1,fail
15654,1,True,6,5,11,1,1,fail
15655,2,True,13,0,13,1,1,pass
15656,2,True,1637,1494,3131,18,1,fail
15657,1,True,10,0,10,1,1,fail
15658,1,True,4,0,4,1,1,fail
15659,2,True,1637,1494,3131,18,1,pass
15663,1,True,4,7,11,1,1,fail
15665,1,True,15,13,28,2,1,fail
15667,1,True,0,0,0,15,1,fail
15669,1,True,1481,1354,2835,12,1,fail
15679,1,False,8,2,10,2,2,pass
15680,2,True,42,8,50,1,1,pass
15681,2,True,104,26,130,6,2,pass
15682,2,True,83,20,103,2,1,pass
15685,1,True,2,1,3,1,1,pass
15687,2,True,205,163,368,11,5,pass
15688,1,True,37,14,51,1,1,pass
15689,2,True,1,11,12,2,2,pass
15694,2,True,66,76,142,4,2,fail
15695,2,True,119,70,189,3,1,pass
15698,2,True,119,70,189,3,1,pass
15699,2,True,0,0,0,0,0,pass
15701,2,True,19,6,25,5,3,pass
15702,2,True,9,3,12,1,1,pass
15703,2,True,10,3,13,4,2,fail
15705,1,True,9,3,12,1,1,pass
15706,2,True,3,1,4,1,1,pass
15707,1,True,2,2,4,1,1,pass
15709,2,True,3,1,4,1,1,pass
15710,1,True,15,11,26,2,1,pass
15711,1,True,1,1,2,1,1,fail
15719,2,True,3,1,4,1,1,pass
15720,2,True,13,60,73,2,1,fail
15721,1,True,56,20,76,2,1,pass
15722,1,True,11,7,18,1,1,pass
15723,1,True,21,6,27,5,2,pass
15724,1,True,11,4,15,4,2,pass
15725,2,True,13,60,73,2,1,pass
15726,1,True,3,1,4,1,1,fail
15727,2,True,422,320,742,12,2,pass
15728,1,True,9,21,30,1,1,fail
15729,2,True,422,320,742,12,2,pass
15730,1,True,18,67,85,1,1,fail
15731,1,True,6,7,13,1,1,pass
15732,1,True,63,52,115,2,2,pass
15733,1,True,64,39,103,4,3,pass
15734,2,True,10,2,12,1,1,pass
15735,2,True,52,16,68,2,1,fail
15737,2,True,52,16,68,2,1,fail
15739,2,True,360,302,662,9,2,pass
15740,1,True,52,16,68,2,1,pass
15741,2,True,360,302,662,9,2,fail
15742,1,True,24,9,33,1,1,fail
15743,1,True,9,0,9,6,2,pass
15745,1,True,5,0,5,1,1,fail
15746,1,True,17,4,21,1,1,fail
15747,1,True,34,42,76,1,1,fail
15748,2,True,628,335,963,53,6,fail
15749,1,True,2,34,36,1,1,pass
15752,1,True,5,6,11,1,1,fail
15755,1,True,1,1,2,1,1,fail
15758,1,True,14,15,29,3,2,fail
15761,1,True,4,4,8,1,1,pass
15764,2,True,628,335,963,53,6,fail
15765,1,True,2,0,2,1,1,pass
15766,1,True,56,48,104,1,1,fail
15767,1,True,2,10,12,1,1,fail
15768,1,True,1,1,2,1,1,fail
15769,1,True,1,1,2,1,1,fail
15771,1,True,3,3,6,1,1,fail
15772,1,True,1,0,1,1,1,fail
15773,1,True,16,6,22,3,2,fail
15774,1,True,3,3,6,1,1,pass
15791,1,True,8,1,9,1,1,fail
15792,1,True,2,1,3,1,1,fail
15793,1,False,1,1,2,1,1,fail
15794,1,False,1,1,2,1,1,pass
15795,2,True,1,1,2,1,1,pass
15796,2,True,145,88,233,14,3,fail
15797,2,True,5,2,7,1,1,fail
15799,2,True,115,73,188,11,3,pass
15800,1,True,6,12,18,1,1,fail
15803,1,True,14,13,27,3,2,pass
15804,1,True,10,8,18,1,1,fail
15805,1,True,3,2,5,1,1,fail
15806,1,True,7,11,18,1,1,fail
15807,1,True,4,3,7,1,1,fail
15808,1,True,3,3,6,1,1,fail
15809,1,True,5,7,12,1,1,fail
15810,1,True,7,17,24,1,1,fail
15811,1,True,14,2,16,1,1,fail
15825,2,True,25,13,38,4,2,fail
15826,1,True,4,13,17,2,1,fail
15828,2,True,2,0,2,1,1,fail
15829,2,True,2,0,2,1,1,fail
15830,2,True,150,95,245,26,6,fail
15831,2,True,1,1,2,1,1,fail
15832,2,True,139,87,226,23,5,fail
15833,2,True,139,87,226,23,5,pass
15834,1,True,4,3,7,1,1,fail
15835,1,True,1,1,2,1,1,fail
15836,1,True,1,0,1,1,1,fail
15838,1,True,5,6,11,1,1,fail
15839,1,True,61,59,120,3,1,fail
15840,1,True,5,2,7,1,1,fail
15841,1,True,1,2,3,1,1,fail
15842,1,True,1,1,2,1,1,fail
15843,1,True,3,1,4,1,1,fail
15844,2,True,10,7,17,2,1,fail
15845,1,True,10,7,17,2,1,fail
15846,1,True,62,40,102,3,2,fail
15848,1,True,2,0,2,1,1,fail
15849,1,True,15,8,23,2,1,fail
15850,1,True,18,0,18,11,2,fail
15853,1,True,4,21,25,1,1,fail
15854,1,True,4,17,21,2,1,fail
15855,1,True,1,1,2,1,1,fail
15856,2,True,66,73,139,11,6,fail
15857,1,True,2,0,2,1,1,fail
15858,1,True,23,46,69,5,1,fail
15859,1,True,7,7,14,4,3,fail
15860,1,True,5,5,10,1,1,fail
15861,1,True,31,15,46,1,1,fail
15862,1,True,0,0,0,6,3,fail
15863,1,True,31,2,33,2,1,fail
15864,1,True,3,2,5,1,1,fail
15865,2,True,40,2,42,2,1,pass
15866,1,True,35,0,35,1,1,fail
15867,2,True,26,10,36,5,3,fail
15868,2,True,1,1,2,1,1,pass
15869,1,True,1,1,2,1,1,fail
15870,2,True,25,9,34,4,2,pass
15871,1,True,1,1,2,1,1,fail
15872,1,True,4,2,6,1,1,fail
15873,1,True,2,1,3,1,1,pass
15874,1,True,2,2,4,1,1,fail
15876,2,True,75,22,97,4,2,pass
15877,1,True,17,0,17,1,1,fail
15878,1,True,23,22,45,3,1,pass
15881,2,True,121,67,188,1,1,pass
15882,1,True,15,2,17,1,1,fail
15887,2,True,3,3,6,2,1,pass
15888,2,True,46,2,48,3,3,fail
15889,2,True,45,2,47,2,2,pass
15890,2,True,1,0,1,1,1,fail
15891,2,True,1,0,1,1,1,pass
15892,1,True,2,2,4,1,1,fail
15893,1,True,43,0,43,1,1,fail
15894,1,True,1,0,1,1,1,fail
15895,1,True,3,3,6,2,1,pass
15896,2,True,38,15,53,4,1,pass
15897,1,True,18,0,18,1,1,pass
15898,1,True,19,14,33,2,1,fail
15901,2,False,1,1,2,1,1,pass
15904,2,True,56,14,70,4,2,fail
15916,1,True,22,17,39,2,1,fail
15917,1,True,31,2,33,2,1,fail
15922,1,True,4,2,6,1,1,fail
15923,1,True,2,1,3,1,1,fail
15924,1,True,12,8,20,1,1,fail
15925,1,True,0,1,1,1,1,fail
15932,1,True,4,1,5,1,1,fail
15935,1,True,1,1,2,1,1,fail
15936,1,True,7,7,14,1,1,fail
15958,2,True,1,1,2,1,1,fail
15960,1,True,1,1,2,1,1,fail
15961,1,True,1,6,7,1,1,fail
15962,1,True,1,1,2,1,1,fail
15964,1,True,36,1,37,2,1,fail
15965,1,True,1,1,2,1,1,fail
15966,1,True,13,4,17,1,1,fail
15967,1,True,11,4,15,2,1,fail
15969,2,True,8,2,10,2,1,fail
15970,1,True,35,0,35,1,1,fail
15973,1,True,1,1,2,1,1,fail
15975,1,True,8,2,10,2,1,fail
15976,1,True,1,0,1,1,1,fail
15977,1,True,1,1,2,1,1,fail
15980,1,True,7,6,13,1,1,fail
16019,1,True,6,5,11,1,1,fail
16021,1,True,18,0,18,1,1,fail
16025,1,True,3,2,5,1,1,fail
16027,1,True,1,3,4,1,1,fail
16042,1,True,2,2,4,2,1,fail
16047,1,True,25,22,47,1,1,fail
16069,1,True,1,0,1,1,1,fail
16070,1,True,13,4,17,2,1,fail
16071,1,True,9,10,19,2,1,fail
16076,1,True,0,3,3,1,1,fail
16122,1,True,2,2,4,2,1,fail
16144,2,True,9,0,9,1,1,fail
16146,1,True,9,0,9,1,1,fail
16149,1,True,2,2,4,1,1,fail
16179,1,True,1,1,2,1,1,fail
16200,1,True,3,0,3,1,1,fail
16220,1,True,4,4,8,1,1,fail
16221,1,True,65,28,93,1,1,fail
16226,1,True,1,1,2,1,1,fail
16228,1,True,15,0,15,1,1,fail
16231,2,True,1,1,2,1,1,fail
16233,1,True,1,1,2,1,1,fail
16234,2,True,6,7,13,2,1,fail
16241,1,True,1,1,2,1,1,fail
16246,1,True,1,1,2,1,1,fail
16247,1,True,22,3,25,2,1,fail
16253,2,True,3,3,6,1,1,fail
16255,1,True,1342,9,1351,20,7,fail
16256,1,True,3,3,6,1,1,fail
16271,2,True,2,1,3,2,2,fail
16274,2,True,2,2,4,1,1,fail
16275,2,True,2,2,4,1,1,fail
16277,2,True,7,2,9,3,1,fail
16278,2,True,7,2,9,3,1,fail
16279,2,True,7,2,9,3,1,fail
16282,1,True,6,1,7,2,1,fail
16283,1,True,1,1,2,1,1,fail
16284,1,True,13,13,26,1,1,fail
16298,2,True,9,3,12,4,2,fail
16342,1,True,1,1,2,1,1,fail
16343,1,True,0,75,75,6,6,fail
16344,1,True,1,1,2,1,1,fail
16345,1,True,1,1,2,1,1,fail
16346,1,True,1,1,2,1,1,fail
16347,1,True,1,1,2,1,1,fail
16349,1,True,1,7,8,1,1,fail
16350,1,True,2,1,3,1,1,fail
16351,2,True,1,1,2,1,1,fail
16353,2,True,1,1,2,1,1,fail
16357,2,True,5,4,9,2,1,fail
16359,1,True,5,4,9,2,1,fail
16360,1,True,1,1,2,1,1,fail
16367,1,True,0,0,0,0,0,fail
16368,1,True,1,1,2,1,1,fail
16371,1,True,1,1,2,1,1,pass
16372,1,True,1,1,2,1,1,fail
16373,1,True,1,1,2,1,1,fail
16374,1,True,2,0,2,1,1,fail
16375,1,True,0,1,1,1,1,fail
16377,1,True,3,3,6,1,1,fail
16378,1,True,4,3,7,1,1,fail
16379,1,True,0,1,1,1,1,fail
16380,1,True,1,3,4,1,1,fail
16381,1,True,2,1,3,1,1,fail
16382,1,True,2,0,2,1,1,fail
16383,1,True,1,1,2,1,1,fail
16384,1,True,1,1,2,1,1,fail
16385,1,True,1,1,2,1,1,fail
16386,1,True,3,3,6,2,2,fail
16387,1,True,2,2,4,1,1,fail
16388,1,True,2,2,4,1,1,fail
16389,1,True,3,3,6,1,1,fail
16390,1,True,0,0,0,0,0,fail
16423,1,False,2,2,4,1,1,fail
16426,1,True,1,1,2,1,1,fail
16427,2,True,14,1,15,2,2,pass
16429,1,True,4,0,4,1,1,fail
16430,1,True,1,1,2,1,1,fail
16431,1,True,2,0,2,1,1,fail
16433,1,True,7,0,7,1,1,fail
16434,1,True,0,0,0,0,0,pass
16435,1,True,3,1,4,2,1,pass
16441,1,True,1,1,2,1,1,fail
16446,1,True,2,0,2,1,1,fail
16447,1,True,1,3,4,1,1,fail
16448,1,True,1,1,2,1,1,fail
16449,1,True,1,0,1,1,1,fail
16450,1,True,0,5,5,1,1,fail
16451,1,True,2,2,4,2,2,fail
16452,1,True,1,1,2,1,1,fail
16455,1,True,1,1,2,1,1,fail
16457,1,True,0,0,0,0,0,fail
16460,1,True,1,1,2,1,1,fail
16461,1,True,0,6,6,1,1,fail
16462,1,True,1,1,2,1,1,fail
16463,1,True,1,1,2,1,1,fail
16465,1,True,1,4,5,2,2,fail
16466,1,True,4,1,5,1,1,fail
16468,1,True,1,1,2,1,1,fail
16469,1,True,1,1,2,1,1,fail
16474,1,True,5,3,8,1,1,fail
16475,1,True,0,0,0,0,0,fail
16476,1,True,1,1,2,1,1,fail
16477,1,True,1,1,2,1,1,fail
16479,1,True,4,0,4,1,1,fail
16480,1,True,0,0,0,0,0,fail
16481,1,True,0,0,0,0,0,fail
16484,1,True,0,0,0,0,0,fail
16487,1,True,6,0,6,1,1,fail
16488,1,True,0,0,0,0,0,fail
16491,1,True,0,0,0,0,0,fail
16492,2,True,37,16,53,2,2,fail
16494,1,True,0,34,34,1,1,fail
16495,1,True,0,0,0,0,0,fail
16496,2,True,6,6,12,1,1,fail
16497,1,True,1,1,2,1,1,fail
16498,1,True,0,0,0,0,0,fail
16499,1,True,0,0,0,0,0,fail
16500,1,True,1,2,3,1,1,fail
16501,1,True,0,0,0,0,0,fail
16502,1,True,1,1,2,1,1,fail
16503,1,True,0,0,0,0,0,fail
16504,1,True,0,0,0,0,0,fail
16505,1,True,1,1,2,1,1,fail
16506,1,True,8,5,13,2,2,fail
16507,1,True,0,0,0,0,0,fail
16508,1,True,1,1,2,1,1,fail
16510,1,True,0,0,0,0,0,fail
16511,1,True,0,0,0,0,0,fail
16512,1,True,0,0,0,0,0,fail
16513,1,True,0,0,0,0,0,fail
16514,1,True,0,0,0,0,0,fail
16515,1,True,0,0,0,0,0,fail
16516,1,True,2,1,3,1,1,fail
16517,1,True,1,1,2,1,1,fail
16518,1,True,1,1,2,1,1,fail
16519,1,True,1,1,2,1,1,fail
16520,1,True,1,0,1,1,1,fail
16521,1,True,1,1,2,1,1,fail
16523,1,True,1,1,2,1,1,fail
16524,1,True,2,0,2,1,1,fail
16525,1,True,1,1,2,1,1,fail
16527,1,True,1,1,2,1,1,fail
16528,1,True,1,1,2,1,1,fail
16529,1,True,1,3,4,2,2,fail
16530,1,True,1,1,2,1,1,fail
16531,1,True,1,1,2,1,1,fail
16532,1,True,1,1,2,1,1,fail
16533,1,True,1,1,2,1,1,fail
16534,1,True,1,2,3,1,1,fail
16535,1,True,1,1,2,1,1,fail
16536,1,True,1,1,2,1,1,fail
16537,1,True,2,1,3,1,1,fail
16538,1,True,2,0,2,1,1,fail
16539,1,True,1,1,2,1,1,fail
16540,1,True,6,5,11,1,1,fail
16541,1,True,1,0,1,1,1,fail
16542,1,True,9,11,20,2,1,fail
16543,1,True,16,11,27,2,2,fail
16544,1,True,8,0,8,2,2,fail
16545,1,False,1,1,2,1,1,fail
16546,1,False,0,0,0,0,0,fail
16547,1,False,2,1,3,1,1,fail
16548,1,False,0,4,4,1,1,fail
16549,1,False,0,2,2,1,1,fail
16550,1,False,7,2,9,1,1,fail
16551,1,False,3,0,3,1,1,fail
16552,1,False,6,2,8,1,1,fail
16553,1,False,5,8,13,1,1,fail
16555,2,True,1598,121,1719,101,18,fail
16556,1,True,2,4,6,1,1,fail
16557,1,True,1,1,2,1,1,fail
16558,1,True,1,1,2,1,1,fail
16559,1,True,0,3,3,1,1,fail
16560,1,True,0,0,0,1,1,fail
16561,1,True,0,2,2,1,1,fail
16562,1,True,0,0,0,2,2,fail
16563,1,True,0,0,0,9,2,fail
16564,1,True,1,1,2,1,1,fail
16565,1,True,2,2,4,1,1,fail
16566,1,True,1415,10,1425,30,16,fail
16567,1,True,0,0,0,2,2,fail
16568,1,True,0,0,0,1,1,fail
16569,1,True,4,2,6,3,3,fail
16570,1,True,0,0,0,47,3,fail
16572,1,True,1,1,2,1,1,fail
16573,1,True,1,0,1,2,2,fail
16574,1,True,0,0,0,1,1,fail
16576,1,True,6,0,6,6,3,fail
16577,1,True,0,0,0,12,2,fail
16578,1,True,30,1,31,2,2,fail
16579,1,True,6,7,13,1,1,fail
16581,1,True,0,0,0,1,1,fail
16582,1,True,0,0,0,15,3,fail
16583,1,True,0,0,0,11,2,fail
16584,1,True,73,75,148,1,1,fail
16585,1,True,39,19,58,3,1,fail
16586,1,True,1,2,3,1,1,fail
16587,1,True,1,1,2,1,1,fail
16588,1,True,9,9,18,1,1,fail
16589,1,True,9,9,18,1,1,fail
16590,1,True,28,0,28,3,2,fail
16591,1,True,1,1,2,1,1,fail
16592,1,True,5,14,19,2,2,fail
16593,1,True,1,1,2,1,1,fail
16594,1,True,1,0,1,1,1,fail
16595,1,True,1,1,2,1,1,fail
16597,1,True,4,1,5,1,1,fail
16598,1,True,0,0,0,0,0,fail
16599,1,True,1,0,1,1,1,fail
16600,1,True,1,0,1,1,1,fail
16601,1,False,391,0,391,1,1,fail
16603,1,True,37,16,53,2,2,fail
16604,1,False,32,1,33,2,1,fail
16606,2,True,3,3,6,2,1,fail
16607,1,False,1,1,2,1,1,pass
16609,1,False,2,2,4,1,1,fail
16610,2,True,1,2,3,1,1,fail
16611,1,True,1,2,3,1,1,pass
16612,1,False,4,1,5,2,2,fail
16613,1,False,7,2,9,1,1,fail
16614,1,False,1,1,2,1,1,fail
16615,1,False,0,4,4,1,1,fail
16616,1,False,0,1,1,1,1,fail
16617,1,False,1,1,2,1,1,fail
16619,1,False,5,1,6,1,1,fail
16620,1,False,5,1,6,1,1,fail
16621,1,False,7,3,10,1,1,fail
16622,1,False,46,3,49,3,1,fail
16623,1,False,1,1,2,1,1,fail
16624,1,False,1,1,2,1,1,fail
16625,1,False,17,19,36,2,1,fail
16626,1,False,18,13,31,4,1,fail
16627,1,False,2,0,2,1,1,fail
16628,1,False,7,44,51,2,1,fail
16629,1,False,8,4,12,2,1,fail
16630,1,False,0,1,1,1,1,fail
16631,1,False,10,4,14,2,1,fail
16632,1,False,2,1,3,1,1,fail
16633,1,False,1,1,2,1,1,fail
16634,1,False,1,1,2,1,1,fail
16635,1,False,1,2,3,1,1,fail
16636,1,False,0,1,1,1,1,fail
16637,1,False,36,15,51,3,1,fail
16638,1,False,24361,28,24389,85,2,fail
16639,1,False,28,20,48,3,1,fail
16640,1,False,11,14,25,1,1,fail
16641,1,False,0,35,35,1,1,fail
16642,1,False,2,1,3,1,1,fail
16643,2,False,16,21,37,3,2,fail
16645,1,False,9,12,21,1,1,fail
16647,1,True,5,6,11,1,1,fail
16648,2,True,2,2,4,1,1,pass
16649,1,True,2,2,4,1,1,fail
16650,1,False,2,2,4,1,1,fail
16651,1,False,5,5,10,1,1,fail
16652,1,False,13,5,18,1,1,fail
16653,1,False,3,1,4,1,1,fail
16654,1,False,0,1,1,1,1,fail
16656,1,False,2,0,2,1,1,fail
16657,1,False,2,1,3,1,1,fail
16658,1,False,85,45,130,2,1,fail
16659,1,False,35,17,52,2,1,fail
16660,1,False,39,0,39,2,1,fail
16661,1,False,1,2,3,1,1,fail
16662,2,True,9,4,13,2,2,fail
16663,2,True,7,0,7,1,1,fail
16664,2,True,1,0,1,1,1,fail
16665,1,True,1,0,1,1,1,fail
16666,1,True,7,0,7,1,1,fail
16667,2,True,2,2,4,1,1,pass
16668,1,True,2,2,4,1,1,pass
16669,1,True,9,4,13,2,2,pass
16670,1,False,1,0,1,1,1,pass
16671,2,True,12,1,13,3,2,fail
16672,2,True,3,2,5,1,1,fail
16673,2,False,24,0,24,2,1,fail
16674,2,True,24,0,24,2,1,fail
16675,1,True,24,0,24,2,1,fail
16676,1,True,3,2,5,1,1,pass
16677,1,True,12,1,13,3,2,fail
16678,1,False,1,1,2,1,1,fail
16679,1,False,1,2,3,1,1,fail
16680,1,False,0,1,1,1,1,fail
16681,1,False,6,0,6,1,1,fail
16682,1,False,5,2,7,1,1,fail
16683,1,False,22,6,28,1,1,fail
16684,1,False,2,0,2,1,1,fail
16686,1,False,16,5,21,3,2,fail
16687,1,False,3,0,3,2,2,fail
16688,1,False,8,6,14,2,1,fail
16690,1,False,26,7,33,3,1,fail
16691,1,False,2,2,4,1,1,fail
16693,1,False,8,6,14,1,1,fail
16694,1,False,4,0,4,1,1,fail
16695,1,False,3,0,3,1,1,fail
16696,1,False,5,0,5,1,1,fail
16697,1,False,1,1,2,1,1,fail
16698,1,False,1,1,2,1,1,fail
16699,1,False,1,0,1,1,1,fail
16700,2,True,324,32,356,5,1,fail
16701,1,False,0,113,113,1,1,fail
16702,1,False,1,0,1,1,1,fail
16704,1,False,7,5,12,2,1,fail
16705,2,True,59,6,65,2,1,fail
16706,1,False,1,1,2,1,1,fail
16707,2,False,12,9,21,3,2,fail
16710,1,True,59,6,65,2,1,pass
16711,2,True,0,5,5,1,1,pass
16712,1,True,0,5,5,1,1,pass
16713,2,True,7,1,8,1,1,fail
16714,1,True,7,1,8,1,1,fail
16715,1,True,318,34,352,5,1,pass
16717,2,True,4,2,6,1,1,fail
16718,2,True,1,1,2,1,1,fail
16719,1,True,1,1,2,1,1,fail
16720,1,False,9,7,16,1,1,fail
16721,1,False,2,2,4,2,2,fail
16723,1,False,0,39,39,1,1,fail
16724,1,False,10,9,19,1,1,fail
16725,1,False,5,3,8,1,1,fail
16726,1,False,2,28,30,4,1,fail
16727,1,False,1,1,2,1,1,fail
16728,1,False,103,51,154,2,1,fail
16729,1,False,43,71,114,2,1,fail
16731,1,False,4,0,4,1,1,fail
16732,1,False,5,5,10,2,2,fail
16733,1,False,0,16,16,1,1,fail
16734,1,False,1,1,2,1,1,fail
16735,1,False,2,2,4,1,1,fail
16736,1,False,1,1,2,1,1,fail
16737,2,True,8,1,9,3,2,fail
16738,2,True,13,0,13,1,1,fail
16739,2,True,2,2,4,1,1,pass
16740,1,True,2,2,4,1,1,fail
16741,1,True,19,12,31,1,1,pass
16742,1,True,7,0,7,2,2,pass
16743,1,True,1,1,2,1,1,fail
16744,1,True,12,6,18,1,1,pass
16745,1,True,4,2,6,1,1,fail
16746,1,False,9,0,9,1,1,fail
16747,1,False,0,13,13,1,1,pass
16750,1,False,2,2,4,2,1,fail
16753,1,False,1,1,2,1,1,fail
16754,1,False,1,0,1,1,1,fail
16756,1,False,1,1,2,1,1,fail
16757,1,False,1,1,2,1,1,fail
16758,1,False,0,30,30,1,1,pass
16759,1,False,8,4,12,1,1,fail
16760,2,True,1,1,2,1,1,fail
16761,1,True,1,1,2,1,1,fail
16762,2,True,4,4,8,2,2,fail
16763,1,True,4,4,8,2,2,fail
16764,2,True,8,0,8,1,1,fail
16765,2,True,4,0,4,1,1,fail
16766,1,True,4,0,4,1,1,fail
16767,1,True,8,0,8,1,1,fail
16768,2,True,14,4,18,3,2,fail
16769,2,True,11,2,13,1,1,fail
16770,1,True,1,1,2,1,1,fail
16771,1,True,14,4,18,3,2,fail
16772,1,True,1,1,2,1,1,fail
16773,1,True,10,1,11,1,1,fail
16774,1,False,13,12,25,1,1,fail
16775,1,False,1,1,2,1,1,fail
16776,1,False,1,0,1,1,1,fail
16777,1,False,12,0,12,1,1,fail
16778,1,False,18,1,19,2,2,fail
16779,1,False,1,1,2,1,1,fail
16780,1,False,5,0,5,1,1,fail
16781,1,False,1,1,2,1,1,fail
16782,2,True,25,2,27,4,3,fail
16783,1,True,1,0,1,1,1,fail
16784,2,True,88,1,89,2,1,fail
16785,2,True,153,24,177,3,1,pass
16787,1,True,1,0,1,1,1,fail
16789,1,False,5,0,5,2,2,fail
16790,1,True,88,1,89,2,1,fail
16791,2,True,3,1108,1111,8,1,pass
16792,1,False,2,0,2,1,1,fail
16794,1,False,13,6,19,2,1,pass
16795,1,True,0,1,1,1,1,pass
16796,1,True,3,1107,1110,8,1,fail
16797,2,True,1,1,2,1,1,pass
16798,1,True,2,2,4,1,1,pass
16799,1,True,1,1,2,1,1,pass
16800,1,True,11,14,25,1,1,pass
16801,2,True,1,1,2,1,1,pass
16802,1,True,1,1,2,1,1,fail
16803,2,True,1,1,2,1,1,fail
16804,1,True,27,16,43,1,1,fail
16806,1,True,1,1,2,1,1,pass
16807,1,True,1,1,2,1,1,pass
16818,2,True,2410,2318,4728,5,1,pass
16819,1,True,3,1,4,2,1,fail
16820,1,True,1,1,2,1,1,fail
16821,1,True,7,7,14,1,1,fail
16822,1,True,2,1,3,1,1,fail
16823,1,True,0,15,15,1,1,fail
16824,1,True,2,38,40,1,1,fail
16825,1,True,2407,2274,4681,2,1,fail
16826,1,True,5,1,6,1,1,fail
16827,1,True,7,4,11,1,1,pass
16828,2,True,3,0,3,1,1,pass
16829,1,True,3,0,3,1,1,pass
16830,2,True,2,0,2,1,1,pass
16831,1,True,2,0,2,1,1,fail
16832,2,True,1,1,2,1,1,pass
16833,2,True,12,7,19,2,1,pass
16834,1,True,1,1,2,1,1,pass
16835,1,True,1,1,2,1,1,pass
16836,2,True,36,6,42,3,1,pass
16837,2,True,53,11,64,4,1,fail
16838,2,True,5,1,6,2,1,pass
16839,1,True,3,0,3,1,1,pass
16841,1,True,3,3,6,2,1,pass
16845,1,True,5,5,10,2,1,pass
16848,1,True,72,36,108,2,1,pass
16854,2,True,35,38,73,6,2,fail
16855,1,True,1,1,2,1,1,pass
16865,1,True,1,1,2,1,1,fail
16871,2,True,6,6,12,1,1,fail
16872,2,True,1,45,46,2,1,fail
16873,2,True,1,1,2,1,1,fail
16874,1,True,1,1,2,1,1,fail
16875,1,False,1,1,2,1,1,fail
16876,1,True,1,45,46,2,1,fail
16877,1,True,6,6,12,1,1,fail
16878,1,False,1,1,2,1,1,fail
16879,1,False,7,3,10,1,1,fail
16880,1,False,4,2,6,2,2,fail
16881,2,True,11,5,16,2,1,pass
16882,2,True,11,8,19,1,1,fail
16883,1,True,11,8,19,1,1,pass
16884,1,True,11,5,16,2,1,pass
16885,2,True,26,0,26,2,1,fail
16886,1,True,1,1,2,1,1,pass
16887,1,True,10,0,10,1,1,fail
16888,1,True,16,0,16,1,1,fail
16889,1,False,1,1,2,1,1,pass
16890,1,False,7,3,10,1,1,pass
16891,1,False,1,1,2,1,1,pass
16892,1,False,5,0,5,1,1,pass
16893,2,True,29,0,29,3,2,pass
16894,1,True,29,0,29,3,2,pass
16895,2,True,1,1,2,1,1,pass
16896,1,True,1,1,2,1,1,fail
16897,1,False,10,1,11,2,2,pass
16899,1,True,1,1,2,1,1,pass
16900,2,True,108,58,166,3,1,pass
16902,1,True,4,5,9,1,1,fail
16903,2,True,47,1,48,2,1,fail
16904,2,True,1,1,2,1,1,pass
16905,1,True,1,1,2,1,1,pass
16906,1,True,5,4,9,1,1,pass
16907,1,True,5,6,11,2,1,pass
16908,1,True,41,6,47,2,1,fail
16911,2,True,16,1,17,2,1,fail
16912,2,True,1,1,2,1,1,fail
16913,1,True,1,1,2,1,1,fail
16914,1,True,3,3,6,1,1,pass
16915,2,True,1,1,2,1,1,fail
16916,1,True,18,3,21,2,1,fail
16917,1,True,1,1,2,1,1,pass
16918,2,True,25,25,50,8,4,fail
16919,1,True,25,25,50,8,4,fail
16920,1,False,1,0,1,1,1,fail
16921,2,True,9,0,9,1,1,fail
16922,2,True,2,2,4,1,1,fail
16923,1,True,1,1,2,1,1,pass
16926,2,True,6,2,8,2,2,fail
16927,1,True,6,2,8,2,2,fail
16928,1,True,9,0,9,1,1,pass
16929,1,True,2,2,4,1,1,pass
16930,2,True,65,8,73,2,1,pass
16931,1,False,1,0,1,1,1,fail
16932,1,False,1,1,2,1,1,fail
16933,1,False,3,3,6,1,1,fail
16934,1,False,1,1,2,1,1,fail
16935,2,True,1,9,10,4,1,pass
16936,1,True,33,0,33,1,1,pass
16937,1,True,2,8,10,1,1,pass
16939,1,True,1,3,4,1,1,pass
16940,1,True,32,8,40,1,1,pass
16941,2,True,0,7,7,1,1,pass
16942,1,True,0,7,7,1,1,fail
16943,2,True,1,1,2,1,1,pass
16944,2,True,2,2,4,1,1,fail
16945,1,True,2,2,4,1,1,pass
16946,1,True,1,1,2,1,1,pass
16947,2,True,16,8,24,1,1,fail
16948,1,True,9,8,17,1,1,fail
16950,1,False,1,1,2,1,1,fail
16951,1,False,2,0,2,1,1,fail
16952,1,False,84,58,142,1,1,fail
16953,2,True,26,1,27,2,1,pass
16954,1,True,4,2,6,1,1,pass
16955,1,True,24,1,25,2,1,pass
16956,2,True,1776,10,1786,6,1,fail
16957,1,True,6,2,8,1,1,pass
16958,1,True,1775,46,1821,6,1,fail
16960,2,True,1,0,1,1,1,fail
16961,2,True,4,0,4,1,1,pass
16962,1,True,4,0,4,1,1,pass
16963,1,True,1,0,1,1,1,fail
16964,1,False,4,4,8,1,1,pass
16965,1,False,1,0,1,1,1,fail
16966,2,True,1,1,2,1,1,fail
16967,1,True,1,1,2,1,1,pass
16968,2,True,1,1,2,1,1,pass
16969,1,True,1,1,2,1,1,fail
16970,2,True,3,3,6,1,1,fail
16971,1,True,3,3,6,1,1,fail
16972,2,True,12,3,15,3,1,fail
16973,1,True,11,2,13,3,1,fail
16974,1,True,1,1,2,1,1,fail
16975,1,False,6,1,7,2,2,pass
16976,2,True,648,6,654,4,1,pass
16977,1,True,4,3,7,1,1,pass
16978,1,True,4,1,5,1,1,fail
16979,1,True,0,1,1,1,1,fail
16980,1,True,7,5,12,2,1,fail
16981,1,True,9,8,17,2,1,fail
16982,2,True,6,1,7,1,1,pass
16983,1,True,639,3,642,4,1,pass
16984,1,True,6,1,7,1,1,pass
16985,2,True,27,1,28,2,1,pass
16986,1,True,27,1,28,2,1,pass
16987,2,True,3,0,3,1,1,fail
16988,1,True,3,0,3,1,1,fail
16989,2,True,2,2,4,1,1,fail
16990,1,True,2,2,4,1,1,pass
16991,2,True,1,1,2,1,1,pass
16992,1,True,1,1,2,1,1,pass
16993,2,True,1,1,2,1,1,fail
16994,1,True,1,1,2,1,1,fail
16995,2,True,6,0,6,1,1,fail
16996,1,True,1,1,2,1,1,fail
16997,2,True,1,1,2,1,1,fail
16998,1,True,1,1,2,1,1,fail
16999,2,True,9,2,11,1,1,fail
17000,1,True,9,2,11,1,1,fail
17001,1,True,6,0,6,1,1,pass
17002,1,False,4,1,5,2,2,pass
17003,1,False,6,3,9,1,1,fail
17004,1,False,6,1,7,1,1,pass
17005,1,False,1,1,2,1,1,pass
17006,1,False,12,0,12,1,1,fail
17007,1,False,1,0,1,1,1,fail
17008,2,True,31,6,37,3,2,fail
17009,2,True,3,3,6,2,1,fail
17012,1,True,1,1,2,1,1,fail
17013,1,True,4,4,8,1,1,fail
17014,1,False,2,1,3,2,2,fail
17015,1,False,3,3,6,1,1,pass
17016,2,True,9,9,18,1,1,pass
17017,1,True,9,9,18,1,1,pass
17018,1,True,19,0,19,1,1,fail
17019,2,True,0,28,28,2,1,pass
17020,1,True,0,28,28,2,1,fail
17021,2,True,28,0,28,2,1,pass
17022,1,True,28,0,28,2,1,fail
17023,1,False,5,4,9,1,1,fail
17025,1,False,1,0,1,1,1,pass
17026,1,False,15,0,15,1,1,fail
17027,2,True,37,6,43,2,1,fail
17028,1,True,10,2,12,1,1,fail
17029,1,True,24,2,26,1,1,fail
17031,1,False,2,0,2,1,1,fail
17032,1,False,1,2,3,1,1,fail
17033,1,False,5,1,6,1,1,fail
17034,1,False,1,3,4,1,1,fail
17035,2,True,7,6,13,1,1,fail
17036,1,True,7,6,13,1,1,fail
17037,2,True,20,0,20,1,1,pass
17038,2,True,0,0,0,0,0,fail
17040,2,True,57,32,89,7,1,pass
17041,1,True,57,32,89,7,1,fail
17042,1,True,19,0,19,1,1,fail
17043,1,False,5,2,7,1,1,pass
17045,1,False,8,0,8,1,1,pass
17049,2,True,1,1,2,1,1,fail
17050,1,True,1,1,2,1,1,pass
17051,1,False,2,0,2,1,1,fail
17052,1,False,1,1,2,1,1,pass
17053,2,True,5,1,6,1,1,fail
17054,1,True,5,1,6,1,1,fail
17055,2,True,9,5,14,1,1,pass
17056,1,True,9,5,14,1,1,fail
17057,2,True,4,4,8,1,1,fail
17058,2,True,45,5,50,2,1,fail
17059,1,True,45,5,50,2,1,pass
17060,1,True,21,1,22,2,1,pass
17061,2,True,13,0,13,1,1,fail
17063,2,True,18,0,18,1,1,pass
17064,1,True,18,0,18,1,1,fail
17065,1,True,4,4,8,1,1,pass
17066,2,True,40,4,44,3,2,pass
17068,2,True,1,0,1,1,1,fail
17069,2,True,6,2,8,1,1,fail
17070,2,True,12,2,14,2,1,fail
17071,2,True,111,39,150,3,1,fail
17072,2,True,11,11,22,1,1,fail
17073,2,True,10,0,10,1,1,fail
17074,2,True,20,2,22,2,1,pass
17075,1,True,0,12,12,1,1,pass
17076,1,True,2,2,4,1,1,pass
17078,1,True,2,0,2,1,1,pass
17079,1,True,3,6,9,2,1,fail
17083,1,True,10,0,10,1,1,pass
17084,1,True,11,11,22,1,1,pass
17085,1,True,8,0,8,1,1,fail
17086,1,True,1,0,1,1,1,pass
17087,2,True,1,1,2,1,1,pass
17088,1,True,1,1,2,1,1,fail
17089,1,True,18,14,32,1,1,pass
17091,1,True,44,1,45,1,1,fail
17093,1,True,2,1,3,1,1,fail
17094,1,True,16,4,20,2,1,fail
17095,2,True,21,0,21,1,1,pass
17096,1,True,21,0,21,1,1,fail
17097,2,True,1,1,2,1,1,pass
17098,1,True,1,1,2,1,1,fail
17099,2,True,1,1,2,1,1,fail
17100,1,True,1,1,2,1,1,fail
17101,1,True,14,5,19,1,1,fail
17102,2,True,38,1,39,2,1,pass
17103,1,False,2,0,2,1,1,fail
17104,1,True,4,2,6,1,1,pass
17105,1,True,6,1,7,1,1,pass
17107,2,True,24,0,24,2,2,pass
17108,1,True,1,1,2,3,3,pass
17109,1,True,6,6,12,2,2,pass
17111,2,True,1,1,2,1,1,pass
17112,1,True,1,1,2,1,1,fail
17113,2,True,2,6,8,2,1,fail
17114,1,True,24,0,24,1,1,pass
17115,2,True,0,1280,1280,1,1,pass
17116,1,True,0,1280,1280,1,1,pass
17117,1,True,2,6,8,2,1,fail
17118,2,True,3,2,5,1,1,fail
17119,1,True,0,1,1,1,1,fail
17120,1,True,3,1,4,1,1,fail
17121,1,True,6,2,8,1,1,fail
17122,2,True,23,58,81,2,2,fail
17123,2,True,3,1,4,1,1,fail
17124,2,True,2,2,4,1,1,fail
17125,1,True,2,2,4,1,1,fail
17126,1,True,3,1,4,1,1,fail
17127,1,True,22,57,79,1,1,pass
17128,1,True,1,1,2,1,1,fail
17129,2,True,3,0,3,1,1,pass
17130,1,True,3,0,3,1,1,fail
17131,1,False,1,0,1,1,1,pass
17132,1,False,2,2,4,1,1,fail
17133,1,False,1,1,2,1,1,fail
17134,1,False,1,0,1,1,1,fail
17135,1,False,1,1,2,1,1,fail
17136,1,False,8,2,10,1,1,fail
17137,1,False,27,1,28,2,1,fail
17138,1,False,1,0,1,1,1,fail
17139,2,True,12,4,16,2,1,fail
17140,1,False,1,0,1,1,1,fail
17141,2,True,49,21,70,4,1,fail
17142,1,True,1,1,2,1,1,pass
17144,2,True,4,0,4,1,1,pass
17146,1,True,49,21,70,4,1,pass
17147,1,True,4,0,4,1,1,fail
17148,2,False,10,3,13,2,1,pass
17150,2,True,10,3,13,2,1,fail
17151,1,False,1,0,1,1,1,fail
17152,2,True,5,3,8,2,2,fail
17153,2,True,6,6,12,1,1,pass
17154,2,True,16,26,42,5,1,pass
17155,1,True,1,1,2,1,1,fail
17160,1,True,6,6,12,1,1,pass
17161,1,True,5,3,8,2,2,pass
17162,1,True,10,3,13,2,1,pass
17163,1,False,1,0,1,1,1,pass
17164,2,True,43,2,45,2,1,fail
17165,1,False,1,0,1,1,1,fail
17166,2,True,36,17,53,1,1,fail
17167,1,False,1,0,1,1,1,fail
17168,2,True,27,33,60,3,1,fail
17169,1,False,2,0,2,1,1,fail
17170,2,True,13,1,14,2,1,fail
17171,1,True,13,1,14,2,1,fail
17172,2,True,1,0,1,1,1,pass
17173,1,True,1,0,1,1,1,fail
17174,1,True,3,1,4,2,1,pass
17176,1,False,1,1,2,1,1,pass
17177,1,False,1,1,2,1,1,fail
17178,1,True,36,17,53,1,1,pass
17179,1,True,1,1,2,1,1,pass
17183,1,False,0,40,40,1,1,pass
17184,1,False,1,0,1,1,1,fail
17185,1,False,3,0,3,1,1,fail
17187,1,False,4,1,5,2,2,fail
17188,1,False,1,1,2,1,1,fail
17189,2,True,5,2,7,1,1,fail
17190,1,False,5,2,7,2,1,fail
17191,1,True,1,1,2,1,1,pass
17192,1,True,5,2,7,1,1,fail
17193,1,True,1,1,2,1,1,fail
17194,1,False,4,2,6,2,2,pass
17195,2,True,2,2,4,1,1,fail
17196,1,True,2,2,4,1,1,pass
17197,1,False,1,2,3,1,1,pass
17198,1,False,4,4,8,1,1,fail
17199,1,False,2,1,3,1,1,pass
17200,1,False,2,1,3,1,1,fail
17201,1,False,1,1,2,1,1,fail
17202,1,False,9,10,19,1,1,fail
17203,1,False,2,2,4,1,1,fail
17204,1,False,2,2,4,1,1,fail
17205,1,False,11,1,12,1,1,fail
17206,1,False,2,0,2,1,1,fail
17207,1,False,11,2,13,1,1,fail
17208,1,False,2,1,3,1,1,fail
17209,1,False,3,2,5,1,1,fail
17210,1,False,19,2,21,1,1,fail
17212,1,False,2,2,4,1,1,fail
17213,1,False,39,5,44,1,1,fail
17214,1,False,18,7,25,1,1,fail
17215,2,True,1,2,3,1,1,fail
17216,1,False,5,39,44,1,1,fail
17217,1,False,10,3,13,1,1,fail
17218,1,False,3,1,4,2,2,fail
17219,2,False,4,3,7,2,2,fail
17221,2,True,1,1,2,1,1,pass
17222,1,True,1,1,2,1,1,fail
17223,2,True,3,2,5,1,1,fail
17225,1,False,1,1,2,1,1,fail
17227,1,False,1,1,2,1,1,fail
17228,1,False,1,19,20,1,1,fail
17229,1,False,19,5,24,1,1,fail
17230,1,False,5,1,6,1,1,fail
17231,1,False,1,1,2,1,1,fail
17233,1,False,1,1,2,1,1,fail
17234,1,False,3,0,3,1,1,fail
17236,1,False,13,13,26,1,1,fail
17237,1,False,6,1,7,1,1,fail
17238,1,False,11,0,11,1,1,fail
17239,1,False,1,1,2,1,1,fail
17240,1,False,6,4,10,1,1,fail
17241,1,False,4,1,5,1,1,fail
17242,1,False,1,1,2,1,1,fail
17243,1,False,10,0,10,1,1,fail
17244,1,False,20,1,21,3,3,fail
17245,1,False,5,1,6,1,1,fail
17246,1,False,3,0,3,1,1,fail
17247,1,False,16,7,23,1,1,fail
17248,1,False,11,0,11,1,1,fail
17249,1,False,4,1,5,2,2,fail
17250,1,False,1,1,2,1,1,fail
17251,2,False,1,1,2,1,1,fail
17253,2,True,1,1,2,1,1,fail
17254,1,True,1,1,2,1,1,pass
17255,1,True,1,2,3,1,1,pass
17256,2,False,1,1,2,1,1,pass
17260,2,True,1,1,2,1,1,fail
17261,1,False,3,1,4,2,2,fail
17264,1,True,1,1,2,1,1,pass
17265,2,True,1,1,2,1,1,pass
17266,1,True,1,1,2,1,1,fail
17267,1,False,0,12,12,1,1,pass
17268,1,False,3,1,4,2,2,fail
17269,1,False,5,0,5,1,1,fail
17270,1,False,1,1,2,1,1,fail
17271,1,False,3,2,5,3,1,fail
17272,1,False,2,2,4,1,1,fail
17273,1,False,21,0,21,1,1,fail
17274,1,False,3,2,5,2,2,fail
17275,1,False,1,0,1,1,1,fail
17276,1,False,2,0,2,1,1,fail
17277,1,False,1,1,2,1,1,fail
17278,1,False,0,1,1,1,1,fail
17279,1,False,30,32,62,9,1,fail
17280,2,True,78,0,78,1,1,fail
17281,1,True,78,0,78,1,1,fail
17282,1,False,2678,1,2679,23,1,fail
17284,1,False,58,9,67,2,1,pass
17285,1,False,1,0,1,1,1,pass
17286,1,False,9,10,19,1,1,fail
17287,1,False,1,1,2,1,1,fail
17288,1,False,4,2,6,1,1,fail
17289,1,False,3,1,4,2,2,fail
17291,1,False,3,1,4,2,2,fail
17293,1,False,1,1,2,1,1,pass
17294,1,False,467,784,1251,1,1,fail
17295,1,False,2,2,4,2,2,fail
17296,2,True,14,5,19,4,2,fail
17297,1,True,14,5,19,4,2,fail
17298,2,True,18,0,18,1,1,fail
17299,1,True,2,2,4,1,1,fail
17300,1,True,18,0,18,1,1,fail
17301,1,False,1,0,1,1,1,fail
17302,1,False,29,2,31,1,1,fail
17303,1,False,2,2,4,1,1,fail
17304,1,False,1,1,2,1,1,fail
17305,1,False,1,0,1,1,1,fail
17306,1,False,11140,81,11221,24,2,fail
17308,1,False,1,1,2,1,1,fail
17309,1,False,1,1,2,1,1,fail
17310,1,False,1,1,2,1,1,fail
17312,1,False,3,2,5,1,1,fail
17313,1,False,0,3,3,1,1,fail
17314,1,False,1,1,2,1,1,fail
17315,1,False,1,1,2,1,1,fail
17316,1,False,2,2,4,2,1,fail
17318,1,False,14,3,17,2,2,fail
17319,1,False,4,4,8,2,1,fail
17320,1,False,5,5,10,1,1,fail
17321,1,False,1,1,2,1,1,fail
17322,1,False,4,4,8,1,1,fail
17323,1,False,1,1,2,1,1,fail
17324,1,False,1,1,2,1,1,fail
17325,1,False,0,23,23,1,1,fail
17326,1,False,7,0,7,1,1,fail
17327,2,False,6,5,11,2,1,fail
17329,2,True,6,5,11,2,1,fail
17330,1,True,6,5,11,2,1,fail
17331,1,False,3,1,4,2,2,fail
17333,1,False,1,1,2,1,1,fail
17335,1,False,3,6,9,1,1,fail
17336,1,False,3,1,4,2,2,fail
17337,1,False,1,1,2,1,1,fail
17338,1,False,7,1,8,1,1,fail
17339,1,False,3,2,5,2,2,fail
17340,1,False,12,5,17,2,1,fail
17341,1,False,4,1,5,2,2,fail
17342,2,False,1,1,2,1,1,fail
17345,2,True,1,1,2,1,1,fail
17346,1,True,1,1,2,1,1,fail
17347,1,False,7,5,12,2,1,fail
17348,1,False,3,1,4,2,2,fail
17349,1,False,5,2,7,1,1,fail
17350,1,False,1,1,2,1,1,fail
17351,1,False,1,1,2,1,1,fail
17352,1,False,2,0,2,1,1,fail
17353,1,False,15,0,15,1,1,fail
17354,1,False,14,0,14,1,1,fail
17355,1,False,0,1,1,1,1,fail
17356,1,False,1,1,2,1,1,fail
17357,1,False,536,483,1019,4,1,fail
17358,1,False,1,1,2,1,1,fail
17359,1,False,1,1,2,1,1,fail
17360,1,False,1,1,2,1,1,fail
17361,1,False,1,1,2,1,1,fail
17362,1,False,7,1,8,1,1,fail
17363,1,False,1,1,2,1,1,fail
17364,1,False,1,0,1,1,1,fail
17365,1,False,2,2,4,1,1,fail
17366,1,False,1,0,1,1,1,fail
17367,1,False,1,2,3,1,1,fail
17368,1,False,3,1,4,2,2,fail
17371,2,True,24,12,36,2,2,pass
17372,1,True,1,0,1,1,1,pass
17373,1,True,0,1,1,1,1,fail
17374,1,True,1,1,2,1,1,fail
17375,2,True,1,1,2,1,1,pass
17376,1,True,2,2,4,3,3,fail
17378,1,True,1,1,2,1,1,pass
17379,2,True,21,9,30,3,2,pass
17380,1,True,21,9,30,3,2,fail
17381,1,False,73,13,86,1,1,fail
17382,1,False,1,1,2,1,1,fail
17386,1,True,1,1,2,1,1,fail
17387,1,True,2,0,2,1,1,fail
17388,1,False,1,1,2,1,1,pass
17389,1,False,2,0,2,1,1,fail
17390,1,False,1,0,1,1,1,fail
17391,1,False,28,0,28,1,1,fail
17392,1,False,0,2,2,1,1,pass
17393,1,False,1,1,2,1,1,fail
17394,1,False,2,0,2,1,1,fail
17395,1,False,10,5,15,1,1,fail
17396,1,False,2,2,4,2,2,pass
17397,2,True,4,0,4,1,1,fail
17398,1,True,4,0,4,1,1,fail
17399,1,False,1,0,1,1,1,pass
17400,1,False,3,2,5,1,1,fail
17401,1,False,1,0,1,1,1,fail
17402,1,False,3,3,6,2,1,fail
17403,1,False,6,2,8,2,1,fail
17404,1,False,19,1,20,1,1,fail
17405,1,False,13,10,23,1,1,fail
17406,1,False,1,0,1,1,1,pass
17407,1,False,1,2,3,1,1,fail
17408,1,False,1,0,1,1,1,fail
17409,1,False,0,1,1,1,1,fail
17410,1,False,740,514,1254,6,1,fail
17411,1,False,1,0,1,1,1,fail
17412,1,False,514,740,1254,6,1,fail
17413,1,False,2,2,4,1,1,fail
17414,1,False,0,1,1,1,1,fail
17415,1,False,1,0,1,1,1,fail
17417,1,False,1,0,1,1,1,fail
17418,1,False,10,1,11,1,1,fail
17419,1,False,7,4,11,2,1,fail
17420,1,False,1,1,2,1,1,fail
17422,1,False,3,2,5,2,2,fail
17423,2,False,15,13,28,5,3,fail
17425,1,False,3,1,4,2,2,pass
17426,2,True,11,11,22,3,2,fail
17427,1,True,11,11,22,3,2,fail
17428,2,True,1,1,2,1,1,pass
17429,1,True,1,1,2,1,1,pass
17430,1,False,3,1,4,2,2,fail
17431,1,False,5,5,10,1,1,fail
17432,1,False,0,11,11,1,1,fail
17433,1,False,3,1,4,2,2,fail
17434,1,False,0,12,12,1,1,fail
17435,1,False,3,3,6,1,1,fail
17436,1,False,25,1,26,2,1,fail
17437,1,False,14,0,14,2,1,fail
17438,2,False,1,1,2,1,1,pass
17440,2,True,1,1,2,1,1,pass
17441,1,True,1,1,2,1,1,fail
17442,1,False,3,1,4,2,2,fail
17443,1,False,2,1,3,1,1,fail
17444,1,False,1,1,2,1,1,fail
17445,1,False,0,1,1,1,1,fail
17446,1,False,1,0,1,1,1,fail
17447,1,False,1,1,2,1,1,fail
17448,1,False,1,1,2,1,1,fail
17450,1,False,1,1,2,1,1,fail
17451,1,False,3,1,4,2,2,fail
17452,1,False,1,1,2,1,1,fail
17453,1,False,1,1,2,1,1,fail
17456,1,False,3,3,6,2,1,fail
17457,1,False,3,1,4,2,2,fail
17458,1,False,59,1,60,2,1,fail
17459,1,False,8,6,14,1,1,fail
17460,1,False,3,1,4,2,2,fail
17461,1,False,5,1,6,1,1,fail
17462,1,False,3,1,4,2,2,fail
17463,1,False,8,6,14,1,1,fail
17464,1,False,1,1,2,1,1,fail
17468,2,True,93,522,615,7,2,fail
17469,1,True,0,25,25,1,1,fail
17470,2,True,25,8,33,3,2,fail
17471,1,True,0,1,1,1,1,fail
17472,1,True,0,353,353,3,1,pass
17474,1,True,1,0,1,1,1,fail
17475,1,True,1,4,5,1,1,fail
17476,1,True,39,118,157,2,1,fail
17478,1,True,20,0,20,1,1,pass
17479,1,True,2,2,4,1,1,fail
17480,1,True,1,1,2,1,1,fail
17481,1,True,2,5,7,2,2,fail
17483,1,True,1,2,3,1,1,fail
17484,1,False,3,1,4,2,2,fail
17486,1,False,3,1,4,2,2,fail
17487,1,False,4,3,7,1,1,fail
17488,1,False,2,0,2,1,1,fail
17489,1,False,1,1,2,1,1,fail
17492,1,False,1,1,2,1,1,fail
17493,1,False,3,1,4,2,2,fail
17495,1,False,1,1,2,1,1,fail
17496,2,True,2,5,7,1,1,fail
17497,1,False,7,1,8,3,2,fail
17498,1,False,1,3,4,1,1,fail
17499,1,False,4,2,6,2,2,fail
17500,1,False,5,6,11,2,2,fail
17501,1,False,1,1,2,1,1,fail
17502,1,False,10,5,15,2,2,fail
17506,1,False,3,0,3,1,1,fail
17507,1,False,6,1,7,1,1,fail
17509,1,False,2,2,4,1,1,fail
17510,1,True,2,5,7,1,1,fail
17511,1,False,1,1,2,1,1,fail
17512,1,False,13,8,21,2,1,fail
17513,1,False,2,2,4,1,1,fail
17514,1,False,1,1,2,1,1,fail
17515,1,False,7,3,10,3,1,fail
17516,1,False,15,0,15,1,1,fail
17517,1,False,0,1,1,1,1,fail
17518,1,False,3,2,5,1,1,fail
17519,1,False,0,13,13,1,1,fail
17520,1,False,3,1,4,2,2,fail
17521,1,False,0,5,5,1,1,fail
17522,1,False,8,2,10,3,2,fail
17523,1,False,1,3,4,1,1,fail
17524,1,False,2,0,2,1,1,fail
17525,1,False,2,1,3,1,1,fail
17526,1,False,0,70,70,1,1,fail
17527,1,False,1,0,1,1,1,fail
17528,1,False,76,72,148,2,1,fail
17529,1,False,3,1,4,2,2,fail
17530,1,False,12,0,12,1,1,fail
17531,1,False,18,3,21,2,1,fail
17532,1,False,53,3,56,1,1,fail
17533,1,False,0,42,42,1,1,fail
17534,1,False,21,21,42,2,2,fail
17535,1,False,3,1,4,2,2,fail
17536,1,False,20,1,21,1,1,fail
17537,1,False,0,1,1,1,1,pass
17538,1,False,1,5,6,1,1,fail
17539,1,False,3,1,4,2,2,fail
17540,1,False,6,1,7,1,1,fail
17541,1,False,3,1,4,2,2,fail
17542,1,False,7,5,12,1,1,fail
17543,1,False,3,1,4,2,2,fail
17544,2,True,4,2,6,1,1,fail
17545,2,True,1,0,1,1,1,fail
17546,1,True,1,0,1,1,1,fail
17547,1,True,4,2,6,1,1,fail
17548,1,False,3,1,4,2,2,fail
17549,1,False,6,1,7,1,1,fail
17550,1,False,4,2,6,3,2,fail
17551,1,False,1,1,2,1,1,fail
17552,1,False,3,1,4,2,2,fail
17553,1,False,4024,1,4025,13,3,fail
17554,1,False,0,1,1,1,1,pass
17555,1,False,3,1,4,2,2,pass
17556,1,False,0,1,1,1,1,fail
17557,1,False,3,6,9,4,2,fail
17558,1,False,0,40,40,1,1,fail
17559,1,False,2,10,12,1,1,fail
17560,2,True,3,3,6,2,2,fail
17561,1,True,3,3,6,2,2,pass
17562,1,False,3,1,4,2,2,pass
17563,2,False,4,1,5,1,1,fail
17566,2,True,4,1,5,1,1,fail
17567,1,True,4,1,5,1,1,fail
17568,1,False,1,0,1,1,1,pass
17569,1,False,1,1,2,1,1,fail
17572,1,False,3,1,4,2,2,fail
17573,1,False,3,0,3,1,1,fail
17574,1,False,0,327,327,1,1,fail
17575,1,False,327,0,327,1,1,fail
17576,1,False,0,40,40,1,1,fail
17577,1,False,1,1,2,1,1,fail
17578,1,False,0,1,1,1,1,fail
17579,1,False,3,0,3,1,1,fail
17580,2,False,1,1,2,1,1,fail
17582,2,True,1,1,2,1,1,fail
17583,1,False,2,2,4,2,1,fail
17584,1,False,1,1,2,1,1,fail
17585,1,False,53,2,55,1,1,fail
17586,1,False,1,1,2,1,1,pass
17587,1,False,1,0,1,1,1,fail
17588,1,False,0,1,1,1,1,fail
17589,1,False,8,2,10,3,2,fail
17590,1,False,1,1,2,1,1,fail
17591,1,False,16,0,16,1,1,fail
17592,2,True,23,10,33,3,3,fail
17594,1,False,10,0,10,1,1,fail
17595,1,False,1,0,1,1,1,fail
17596,1,False,12,10,22,1,1,fail
17597,1,False,1,1,2,1,1,fail
17598,1,False,26,0,26,1,1,fail
17599,1,False,2,0,2,1,1,fail
17600,1,False,2,2,4,1,1,fail
17601,1,False,1,1,2,1,1,fail
17603,1,False,1,1,2,1,1,fail
17604,1,False,0,20,20,1,1,fail
17605,1,False,2,0,2,1,1,fail
17606,1,False,2,2,4,1,1,fail
17607,1,False,7,3,10,1,1,fail
17608,1,False,1,1,2,1,1,pass
17609,1,False,1,1,2,1,1,fail
17611,1,False,4,4,8,1,1,fail
17612,1,False,9,4,13,1,1,fail
17613,1,False,1,1,2,1,1,fail
17615,1,False,13,5,18,1,1,fail
17616,1,False,2,2,4,1,1,fail
17617,1,False,1,1,2,1,1,fail
17618,1,False,3,1,4,2,2,fail
17619,1,False,3,1,4,2,2,fail
17620,1,False,26,28,54,1,1,fail
17622,1,False,2,0,2,1,1,fail
17623,1,False,2,0,2,1,1,fail
17624,2,True,15,17,32,3,2,fail
17625,1,True,1,1,2,1,1,pass
17626,1,True,2,6,8,1,1,fail
17627,2,True,1,1,2,1,1,pass
17628,1,True,4,4,8,1,1,fail
17629,1,True,1,1,2,1,1,fail
17630,1,True,1,1,2,1,1,pass
17631,1,True,1,1,2,1,1,fail
17632,1,True,4,4,8,2,1,fail
17636,2,True,765,411,1176,7,3,pass
17637,1,True,1,7,8,1,1,fail
17638,1,True,1,1,2,1,1,fail
17639,1,True,1,1,2,1,1,fail
17640,1,True,1,1,2,1,1,fail
17641,1,True,2,2,4,2,2,fail
17642,2,True,4,3,7,1,1,fail
17644,2,True,16,16,32,2,1,fail
17646,2,True,281,8,289,2,1,fail
17647,1,True,4,4,8,1,1,fail
17649,1,True,115,13,128,1,1,fail
17650,1,True,1,1,2,1,1,pass
17652,1,True,17,17,34,2,1,fail
17653,1,True,490,404,894,2,1,fail
17654,1,False,4,1,5,2,2,pass
17655,1,False,0,1,1,1,1,fail
17656,1,False,3,1,4,1,1,pass
17657,1,False,3,1,4,2,2,fail
17658,1,False,29,24,53,1,1,fail
17659,1,False,0,2,2,1,1,fail
17660,1,False,1,1,2,1,1,fail
17661,1,False,10,0,10,1,1,fail
17662,1,False,3,0,3,1,1,pass
17663,1,False,3,1,4,2,2,fail
17664,1,False,20,13,33,2,1,fail
17665,1,False,3,1,4,2,2,fail
17666,1,False,1,1,2,1,1,fail
17667,1,False,4,1,5,1,1,fail
17668,1,False,1,1,2,1,1,fail
17669,1,False,1,1,2,1,1,fail
17670,1,False,4,2,6,2,2,fail
17672,1,False,21,1,22,2,2,pass
17673,1,False,60,42,102,2,1,fail
17674,1,False,30,6,36,3,1,pass
17675,1,False,3,1,4,2,2,pass
17676,1,False,3,0,3,1,1,fail
17677,1,False,1,0,1,1,1,fail
17678,1,False,1,1,2,1,1,fail
17679,1,False,1,0,1,1,1,fail
17680,1,False,1,0,1,1,1,fail
17681,1,False,39,38,77,2,1,fail
17682,1,False,26,37,63,1,1,fail
17683,1,False,3,1,4,2,2,fail
17686,1,False,20,2,22,1,1,fail
17687,1,False,1,1,2,1,1,pass
17688,1,False,1,1,2,1,1,fail
17689,1,False,1,1,2,1,1,fail
17690,1,False,1,1,2,1,1,fail
17694,1,False,1,0,1,1,1,pass
17695,1,False,1,1,2,1,1,fail
17696,1,False,1,1,2,1,1,fail
17698,1,False,5,5,10,1,1,fail
17699,2,False,5,5,10,1,1,fail
17707,2,True,5,5,10,1,1,pass
17708,1,True,5,5,10,1,1,fail
17709,1,False,1,0,1,1,1,pass
17710,1,False,2,8,10,1,1,fail
17711,1,False,1,0,1,1,1,fail
17713,2,False,8,2,10,1,1,fail
17716,1,False,8,2,10,1,1,pass
17717,1,False,1,0,1,1,1,pass
17718,1,False,5,2,7,2,2,fail
17720,2,False,23,7,30,1,1,fail
17723,1,False,1,1,2,1,1,fail
17724,1,False,23,0,23,1,1,fail
17725,1,False,5,4,9,1,1,fail
17726,1,False,106,43,149,6,3,fail
17727,1,False,4,1,5,2,2,pass
17728,1,False,25,16,41,3,1,fail
17729,1,False,22,0,22,1,1,pass
17730,1,False,1,0,1,1,1,pass
17731,1,False,28,26,54,1,1,fail
17732,1,False,26,28,54,1,1,fail
17733,1,False,0,0,0,1,1,fail
17734,1,False,1,1,2,1,1,pass
17735,1,False,11,9,20,2,1,fail
17736,1,False,1,0,1,1,1,fail
17737,1,False,31,0,31,3,2,fail
17738,1,False,6,5,11,1,1,fail
17739,1,False,1,0,1,1,1,pass
17740,1,False,19,3,22,3,2,pass
17741,1,False,4,4,8,1,1,pass
17744,1,False,1,2,3,1,1,pass
17746,1,False,27,10,37,1,1,fail
17747,1,False,19,17,36,1,1,fail
17748,1,False,11,6,17,1,1,fail
17749,2,True,2,7,9,1,1,fail
17750,1,True,2,7,9,1,1,fail
17752,2,True,42,68,110,8,6,fail
17753,1,False,5,1,6,1,1,fail
17754,1,False,11,10,21,1,1,fail
17755,1,False,13,11,24,1,1,fail
17756,2,True,3,3,6,1,1,fail
17757,2,True,14,10,24,1,1,fail
17758,1,True,14,10,24,1,1,fail
17759,2,True,2,1,3,2,1,fail
17760,1,True,2,1,3,2,1,fail
17761,1,False,3,0,3,1,1,fail
17762,1,True,0,3,3,1,1,fail
17763,1,True,3,0,3,1,1,fail
17764,2,False,1,1,2,1,1,fail
17766,2,True,7544,43,7587,10,4,fail
17768,2,True,1,1,2,1,1,fail
17769,1,True,1,1,2,1,1,fail
17770,1,False,1,0,1,1,1,fail
17771,1,False,7527,40,7567,5,3,fail
17772,1,False,1,1,2,1,1,pass
17773,1,False,2,0,2,1,1,fail
17774,1,False,12,1,13,2,1,fail
17775,2,False,5,5,10,1,1,pass
17777,2,True,5,5,10,1,1,fail
17778,1,False,7,2,9,1,1,fail
17779,1,False,1,1,2,1,1,fail
17780,1,False,5,1,6,1,1,fail
17782,1,False,1,1,2,1,1,fail
17783,1,False,2,2,4,1,1,fail
17784,1,False,3,1,4,2,2,fail
17785,1,False,15,6,21,1,1,fail
17786,1,True,5,5,10,1,1,fail
17787,1,False,3,1,4,2,2,fail
17788,1,False,1,1,2,1,1,fail
17789,1,False,3,1,4,2,2,fail
17790,1,False,10,3,13,1,1,fail
17791,1,False,2,2,4,1,1,fail
17792,1,False,4,1,5,2,2,fail
17793,1,False,0,3,3,1,1,fail
17794,1,False,1,1,2,1,1,fail
17795,1,False,3,4,7,1,1,fail
17796,1,False,23,10,33,1,1,fail
17797,2,False,10,12,22,2,1,fail
17799,1,False,1,1,2,1,1,fail
17800,1,False,9,8,17,1,1,fail
17801,1,False,0,3,3,1,1,fail
17802,1,False,2,2,4,1,1,fail
17803,2,True,1,1,2,1,1,fail
17804,1,True,1,1,2,1,1,fail
17805,1,False,1,1,2,1,1,fail
17806,1,False,5,0,5,1,1,fail
17807,1,False,20,0,20,1,1,fail
17808,1,False,48,0,48,1,1,fail
17809,1,False,1,1,2,1,1,fail
17810,1,False,1,1,2,1,1,fail
17811,1,False,1,1,2,1,1,fail
17812,1,False,2,2,4,1,1,fail
17813,1,False,1,1,2,1,1,fail
17814,1,False,2,0,2,1,1,fail
17815,1,False,3,6,9,1,1,fail
17816,1,False,1,0,1,1,1,fail
17817,1,False,2,0,2,1,1,fail
17818,1,False,1,3,4,1,1,fail
17819,1,False,13,0,13,1,1,fail
17820,1,False,2,1,3,1,1,fail
17821,1,False,8,8,16,1,1,fail
17822,1,False,1,0,1,1,1,fail
17824,1,False,0,2,2,1,1,fail
17825,1,False,2,3,5,2,1,fail
17827,1,False,2,1,3,1,1,fail
17828,1,False,3,3,6,1,1,fail
17829,1,False,4,0,4,1,1,fail
17830,1,False,2,0,2,1,1,fail
17831,1,False,1,1,2,1,1,fail
17832,1,False,365,3,368,2,1,fail
17833,1,False,4,2,6,3,2,pass
17834,1,False,1,1,2,1,1,pass
17835,1,False,1,0,1,1,1,pass
17836,1,False,1,1,2,1,1,fail
17837,1,False,4,2,6,1,1,fail
17838,1,False,4,1,5,1,1,fail
17839,1,False,1,0,1,1,1,fail
17840,1,False,349,1,350,6,1,fail
17841,1,False,12,10,22,1,1,fail
17842,1,False,1,1,2,1,1,fail
17843,1,False,1,1,2,1,1,fail
17844,1,False,1,1,2,1,1,fail
17845,1,False,1,0,1,1,1,fail
17846,1,False,0,1,1,1,1,fail
17847,1,False,924,3,927,9,1,fail
17848,1,False,9,1,10,1,1,pass
17849,1,False,3,1,4,2,2,fail
17850,1,False,1,1,2,1,1,fail
17851,1,False,28,29,57,1,1,pass
17852,1,False,5,1,6,2,2,pass
17853,1,False,1,1,2,1,1,pass
17854,1,False,4,0,4,1,1,fail
17855,1,False,21,8,29,2,1,fail
17856,1,False,1,1,2,1,1,pass
17858,1,False,10,2,12,3,2,fail
17859,1,False,3,1,4,2,2,fail
17860,1,False,4,4,8,1,1,fail
17861,1,False,2,2,4,1,1,fail
17862,1,False,1,1,2,1,1,fail
17863,1,False,1,1,2,1,1,fail
17864,1,False,33,3,36,3,3,fail
17865,2,True,2,2,4,1,1,pass
17866,1,False,3,1,4,2,2,fail
17868,1,True,2,2,4,1,1,fail
17869,1,False,2,2,4,1,1,pass
17870,1,False,1,1,2,1,1,pass
17871,1,False,31,12,43,2,2,fail
17872,1,False,1,1,2,1,1,pass
17873,1,False,1,1,2,1,1,fail
17874,1,False,46,26,72,3,2,fail
17875,1,False,3,1,4,2,2,pass
17876,1,False,27,4,31,3,1,fail
17877,1,False,3,1,4,2,2,pass
17878,1,False,1,1,2,1,1,fail
17879,1,False,3,1,4,2,2,pass
17881,1,False,1,1,2,1,1,fail
17882,1,False,1,1,2,1,1,fail
17883,1,False,1,1,2,1,1,fail
17884,1,False,15,7,22,1,1,fail
17885,1,False,4,1,5,2,2,fail
17886,1,False,19,11,30,1,1,fail
17887,1,False,17,4,21,1,1,fail
17888,1,False,40,13,53,2,1,fail
17889,1,False,1,1,2,1,1,fail
17890,1,False,3,0,3,1,1,fail
17891,1,False,3,1,4,2,2,fail
17892,1,False,9,4,13,1,1,fail
17893,1,False,1,1,2,1,1,fail
17894,1,False,3,1,4,2,2,pass
17895,1,False,3,7,10,2,1,fail
17896,1,False,1,0,1,1,1,pass
17897,1,False,4,1,5,1,1,pass
17898,1,False,3,1,4,2,2,fail
17899,1,False,8,7,15,1,1,fail
17900,1,False,17,13,30,1,1,fail
17901,1,False,3,1,4,2,2,pass
17902,1,False,11,0,11,1,1,fail
17903,1,False,39,0,39,1,1,pass
17904,1,False,1,1,2,1,1,fail
17905,1,False,0,4,4,1,1,fail
17906,1,False,0,1,1,1,1,fail
17907,1,False,1,0,1,1,1,fail
17908,1,False,3,3,6,1,1,fail
17909,1,False,5,5,10,1,1,fail
17910,1,False,16,2,18,1,1,fail
17911,1,False,4,1,5,2,2,pass
17912,1,False,1,1,2,1,1,fail
17913,2,True,1,1,2,1,1,fail
17914,1,True,1,1,2,1,1,fail
17915,1,False,19,2,21,1,1,pass
17916,1,False,95,107,202,1,1,fail
17917,2,True,1,1,2,1,1,pass
17918,1,True,1,1,2,1,1,pass
17919,2,True,16,20,36,2,1,pass
17920,1,True,0,4,4,2,1,pass
17923,1,False,3,1,4,2,2,pass
17924,2,True,29,1,30,2,1,fail
17925,1,True,29,1,30,2,1,fail
17926,2,True,1,0,1,1,1,pass
17927,1,False,3,2,5,2,2,fail
17929,1,True,1,0,1,1,1,fail
17930,1,False,3,1,4,2,2,pass
17931,2,True,20,6,26,1,1,pass
17932,2,True,13,0,13,1,1,fail
17933,2,True,7,5,12,1,1,fail
17934,2,True,1,1,2,1,1,fail
17935,1,True,7,5,12,1,1,pass
17936,1,True,13,0,13,1,1,pass
17937,1,True,2,2,4,1,1,pass
17938,2,True,0,0,0,0,0,pass
17940,1,True,1,1,2,1,1,fail
17941,1,True,5,1,6,1,1,pass
17942,1,True,7,2,9,1,1,pass
17943,2,True,1,1,2,1,1,pass
17944,1,True,10,5,15,1,1,pass
17945,2,True,1,1,2,1,1,pass
17947,1,True,1,1,2,1,1,pass
17948,1,False,10,9,19,1,1,pass
17949,1,False,2,0,2,1,1,pass
17950,1,False,1,2,3,1,1,fail
17952,2,True,6,3,9,1,1,pass
17953,2,True,61,15,76,5,1,fail
17954,1,True,14,0,14,1,1,fail
17955,1,True,6,3,9,1,1,fail
17956,1,True,12,0,12,1,1,fail
17957,1,True,2,2,4,1,1,fail
17958,1,True,1,1,2,1,1,fail
17959,1,True,1,2,3,1,1,fail
17960,1,True,1,1,2,1,1,fail
17961,1,True,0,1,1,1,1,fail
17962,1,True,1,1,2,1,1,fail
17963,1,True,1,0,1,1,1,fail
17964,1,True,1,1,2,1,1,fail
17965,1,True,1,1,2,1,1,fail
17966,1,True,1,1,2,1,1,fail
17967,1,True,31,10,41,2,1,fail
17968,1,False,1,1,2,1,1,fail
17969,1,False,1,1,2,1,1,fail
17973,1,False,1,1,2,1,1,fail
17974,2,True,13,1,14,1,1,fail
17975,2,True,1,1,2,1,1,fail
17976,1,False,1,1,2,1,1,fail
17977,2,True,5,1,6,1,1,pass
17978,2,True,24,11,35,3,2,pass
17979,1,True,5,1,6,1,1,fail
17980,1,True,13,3,16,2,1,fail
17981,1,True,1,1,2,1,1,pass
17982,1,True,1,1,2,1,1,fail
17983,1,True,1,1,2,1,1,fail
17984,1,True,1,1,2,1,1,fail
17985,1,True,15,0,15,1,1,fail
17986,1,True,2,2,4,1,1,fail
17987,1,True,2,2,4,1,1,fail
17988,1,True,5,7,12,1,1,fail
17989,1,True,2,2,4,1,1,fail
17990,1,True,3,1,4,1,1,fail
17991,1,True,1,1,2,1,1,fail
17992,1,True,1,3,4,1,1,fail
17993,1,True,2,0,2,1,1,fail
17994,2,True,1,1,2,1,1,fail
17995,1,True,1,1,2,1,1,fail
17996,1,False,2,2,4,1,1,fail
17997,1,False,2,2,4,1,1,fail
17998,1,False,4,1,5,1,1,fail
17999,1,False,4,0,4,300,6,fail
18000,1,False,5939,10,5949,85,2,fail
18001,1,False,1,1,2,1,1,fail
18002,1,False,1,1,2,1,1,fail
18004,1,False,3,1,4,2,2,fail
18005,1,False,421,183,604,2,1,fail
18006,1,False,1,1,2,1,1,fail
18007,1,False,0,2,2,1,1,fail
18008,1,False,1,1,2,1,1,fail
18010,1,False,2,1,3,1,1,fail
18011,1,False,85770,10,85780,251,6,fail
18012,1,False,2,2,4,1,1,fail
18013,1,False,3,0,3,1,1,fail
18014,1,False,7,2,9,1,1,fail
18015,1,False,2,1,3,1,1,fail
18016,1,False,1,1,2,1,1,fail
18017,2,False,1,1,2,1,1,fail
18019,2,True,1,1,2,1,1,fail
18020,1,False,3,1,4,2,2,fail
18022,1,False,1,1,2,1,1,fail
18023,1,False,5,5,10,1,1,fail
18024,1,True,1,1,2,1,1,fail
18025,1,False,3,1,4,2,2,fail
18026,1,False,1,1,2,1,1,fail
18027,1,False,0,15,15,1,1,fail
18028,1,False,1,1,2,1,1,fail
18029,1,False,4,2,6,3,2,fail
18030,1,False,0,8,8,1,1,fail
18031,1,False,7,7,14,1,1,fail
18032,1,False,1,47,48,1,1,fail
18033,1,False,1,1,2,1,1,fail
18034,1,False,1,1,2,1,1,fail
18035,1,False,1,2,3,2,2,fail
18036,1,False,1,2,3,2,2,fail
18038,1,False,3,0,3,1,1,fail
18039,1,False,8,7,15,2,1,fail
18040,1,False,2,2,4,2,1,fail
18041,1,False,1,1,2,1,1,fail
18042,1,False,1,1,2,1,1,fail
18043,1,False,104,92,196,1,1,fail
18044,1,False,1,0,1,1,1,fail
18045,1,False,1,5,6,1,1,fail
18046,1,False,3,0,3,1,1,fail
18047,1,False,1,0,1,1,1,fail
18048,1,False,4,2,6,2,1,fail
18049,1,False,3,1,4,1,1,fail
18050,1,False,2,2,4,2,1,fail
18051,1,False,3,6,9,2,1,fail
18052,1,False,1,0,1,1,1,fail
18053,1,False,5,0,5,1,1,fail
18054,1,False,1,1,2,1,1,fail
18055,1,False,4,0,4,1,1,fail
18056,1,False,1,1,2,1,1,fail
18057,1,False,8,2,10,1,1,fail
18058,1,False,2,2,4,2,2,fail
18059,1,False,32,18,50,2,2,fail
18060,1,False,2,1,3,1,1,fail
18061,1,False,14,1,15,1,1,fail
18062,1,False,3,3,6,1,1,fail
18065,1,False,49,39,88,1,1,fail
18066,2,False,2,2,4,2,1,fail
18068,1,False,0,3,3,1,1,fail
18069,2,True,5,2,7,3,2,fail
18070,1,False,1,0,1,1,1,fail
18071,1,False,2,0,2,1,1,fail
18072,1,False,1,1,2,1,1,fail
18073,1,False,12,1,13,1,1,fail
18074,1,True,0,0,0,1,1,fail
18075,1,True,1,1,2,1,1,fail
18076,1,True,6,4,10,4,3,fail
18079,1,True,3,2,5,1,1,fail
18080,1,True,1,1,2,1,1,fail
18081,1,False,0,2,2,1,1,fail
18082,1,False,108,80,188,2,1,fail
18083,1,False,5,1,6,2,2,fail
18084,2,True,11,1,12,2,1,fail
18085,1,False,6,3,9,1,1,fail
18086,1,False,1,1,2,1,1,fail
18087,1,True,11,1,12,2,1,fail
18088,1,False,14,52,66,2,2,fail
18089,1,False,1,0,1,1,1,fail
18090,1,False,75,23,98,1,1,fail
18091,1,False,2,1,3,1,1,fail
18092,1,False,18,2,20,1,1,fail
18093,1,False,6,0,6,1,1,fail
18094,1,False,5,5,10,2,1,fail
18095,1,False,5,2,7,3,2,fail
18096,1,False,67,25,92,3,1,fail
18097,1,False,7,7,14,1,1,fail
18098,1,False,21,20,41,1,1,fail
18099,1,False,27,19,46,1,1,fail
18100,1,False,2,0,2,1,1,fail
18101,1,False,1,0,1,1,1,fail
18102,1,False,1,1,2,1,1,fail
18103,1,False,12,12,24,1,1,fail
18104,1,False,18,2,20,1,1,fail
18105,1,False,6,0,6,1,1,fail
18106,1,False,0,5,5,1,1,fail
18107,1,False,4,1,5,2,2,fail
18108,2,True,149,46,195,2,1,fail
18109,1,True,3,1,4,1,1,fail
18110,1,True,1,1,2,1,1,fail
18111,1,True,1,0,1,1,1,fail
18112,1,True,4,3,7,2,1,fail
18113,1,True,28,59,87,1,1,fail
18114,1,True,161,42,203,2,1,fail
18115,1,True,18,7,25,1,1,fail
18116,1,False,4,2,6,3,2,fail
18117,1,False,3,1,4,2,2,fail
18119,1,False,2,1,3,1,1,fail
18120,1,False,46,38,84,2,1,fail
18121,1,False,1,1,2,1,1,fail
18122,1,False,4,3,7,1,1,fail
18123,1,False,3,1,4,2,2,fail
18125,1,False,1,0,1,1,1,fail
18126,1,False,1,1,2,1,1,fail
18127,1,False,1,1,2,1,1,fail
18128,1,False,3,4,7,1,1,fail
18129,1,False,1,0,1,1,1,fail
18130,1,False,17,0,17,1,1,fail
18131,1,False,1,0,1,1,1,fail
18132,1,False,1,1,2,1,1,fail
18133,1,False,1,1,2,1,1,fail
18134,1,False,1,1,2,1,1,fail
18135,1,False,0,3,3,1,1,fail
18136,1,False,1,0,1,1,1,fail
18137,1,False,7,3,10,2,1,fail
18138,1,False,15,9,24,1,1,fail
18139,1,False,0,12,12,1,1,fail
18140,1,False,3,35,38,1,1,fail
18141,1,False,4,1,5,2,2,fail
18142,1,False,1,1,2,1,1,fail
18143,1,False,5,5,10,1,1,fail
18144,1,False,15,2,17,1,1,fail
18145,2,True,1,1,2,1,1,fail
18146,1,False,16,11,27,1,1,fail
18147,1,False,3,3,6,1,1,fail
18149,1,False,2,2,4,1,1,fail
18150,1,False,65,140,205,1,1,fail
18151,1,False,11,9,20,1,1,fail
18152,1,False,1,2,3,1,1,pass
18153,1,False,3,1,4,2,2,pass
18154,1,False,8,3,11,1,1,pass
18155,1,True,1,1,2,1,1,fail
18156,1,False,4,1,5,2,2,fail
18157,1,False,2,2,4,1,1,fail
18158,1,False,67,64,131,1,1,fail
18159,1,False,4,3,7,1,1,fail
18160,1,False,1,1,2,1,1,pass
18161,1,False,10,1,11,1,1,pass
18162,1,False,29,29,58,1,1,pass
18163,1,False,44,6,50,1,1,pass
18164,1,False,0,1,1,1,1,pass
18165,1,False,2,0,2,1,1,fail
18167,1,False,15,10,25,1,1,fail
18168,1,False,1,1,2,1,1,fail
18169,1,False,2,0,2,1,1,fail
18170,1,False,1,1,2,1,1,fail
18171,1,False,1,3,4,1,1,fail
18172,1,False,1,0,1,1,1,fail
18173,1,False,7,1,8,1,1,fail
18174,1,False,1,1,2,1,1,fail
18175,1,False,1,0,1,1,1,fail
18177,1,False,2,0,2,1,1,fail
18178,1,False,3,5,8,2,2,fail
18179,1,False,3,1,4,2,2,fail
18180,1,False,7,3,10,2,1,fail
18181,2,False,2,2,4,2,1,fail
18183,2,True,1,1,2,1,1,fail
18184,1,True,1,1,2,1,1,fail
18185,2,True,1,1,2,1,1,fail
18186,1,True,1,1,2,1,1,fail
18187,1,False,1,1,2,1,1,fail
18188,1,False,1,0,1,1,1,fail
18189,1,False,3,5,8,2,1,fail
18190,1,False,1,3,4,1,1,fail
18191,1,False,2,0,2,1,1,fail
18192,1,False,54,9,63,2,1,fail
18193,1,False,2,2,4,1,1,pass
18194,1,False,6,4,10,1,1,pass
18195,1,False,1,1,2,1,1,pass
18196,2,False,0,1,1,1,1,pass
18199,1,False,4,1,5,2,2,fail
18201,1,False,0,1,1,1,1,pass
18202,2,True,8,0,8,1,1,fail
18203,1,True,8,0,8,1,1,fail
18204,1,False,1,1,2,1,1,fail
18205,1,False,4,1,5,1,1,fail
18206,2,True,2,0,2,1,1,fail
18207,1,True,2,0,2,1,1,fail
18208,1,False,4,1,5,1,1,fail
18209,2,True,1,1,2,1,1,fail
18210,1,False,3,13,16,1,1,fail
18211,1,False,14,0,14,1,1,fail
18212,1,False,6,3,9,1,1,fail
18213,1,False,1,1,2,1,1,fail
18214,1,False,6,6,12,1,1,fail
18215,1,False,2,0,2,1,1,fail
18217,1,False,4,2,6,1,1,fail
18218,1,False,2,1,3,1,1,fail
18219,2,True,576,0,576,3,2,fail
18220,1,False,573,0,573,3,2,fail
18222,1,False,6,0,6,1,1,fail
18223,1,False,1,1,2,1,1,fail
18224,1,False,1,1,2,1,1,fail
18225,1,False,1,1,2,1,1,fail
18226,1,False,1,1,2,1,1,fail
18227,1,False,29,0,29,1,1,fail
18228,1,False,6,54,60,2,2,fail
18229,1,False,4,0,4,2,1,fail
18230,1,False,2,0,2,1,1,fail
18231,1,False,1,0,1,1,1,pass
18232,1,False,1,0,1,1,1,pass
18233,1,False,2,1,3,1,1,pass
18234,1,False,30,14,44,1,1,pass
18235,1,False,2,1,3,1,1,pass
18236,1,False,1,0,1,1,1,fail
18237,1,False,1,1,2,1,1,fail
18238,1,False,29,1,30,2,1,fail
18239,1,False,3,1,4,1,1,fail
18240,1,False,3,1,4,1,1,fail
18241,1,False,3,0,3,1,1,fail
18242,1,False,2,2,4,1,1,fail
18243,1,False,1,1,2,1,1,fail
18244,1,False,4,0,4,1,1,fail
18245,1,False,0,1,1,1,1,fail
18246,1,False,20,13,33,1,1,fail
18247,1,False,12,5,17,1,1,fail
18248,1,False,8,4,12,1,1,fail
18249,1,False,134,28,162,1,1,fail
18250,1,False,43,12,55,1,1,fail
18251,1,False,7,2,9,1,1,fail
18252,1,False,5,3,8,1,1,fail
18253,1,False,2,1,3,1,1,fail
18254,1,False,1,1,2,1,1,fail
18255,1,False,1,1,2,1,1,fail
18256,1,False,3,2,5,1,1,fail
18257,1,False,1,1,2,1,1,fail
18258,1,False,22,4,26,1,1,pass
18259,1,False,35,50,85,2,1,pass
18260,1,False,44,0,44,1,1,pass
18262,1,False,10,12,22,2,2,fail
18263,1,False,4,0,4,1,1,fail
18264,1,False,1,1,2,1,1,fail
18265,1,False,1,0,1,1,1,fail
18266,1,False,2,2,4,1,1,fail
18267,1,False,2,1,3,1,1,fail
18268,1,False,6,3,9,1,1,fail
18269,1,False,1,1,2,1,1,fail
18270,1,False,0,1,1,1,1,fail
18271,1,False,4,1,5,2,2,fail
18272,1,False,1,0,1,1,1,pass
18273,1,False,30,73,103,1,1,fail
18274,1,False,6,5,11,1,1,pass
18275,2,True,37,28,65,3,2,pass
18276,1,True,14,13,27,2,1,pass
18277,2,True,0,0,0,0,0,fail
18281,1,True,24,16,40,3,2,fail
18283,1,False,2,0,2,1,1,pass
18284,2,True,14,6,20,5,2,pass
18286,1,True,3,3,6,1,1,pass
18287,1,True,3,0,3,1,1,pass
18289,1,True,1,1,2,1,1,pass
18290,1,True,3,1,4,1,1,fail
18291,1,True,8,4,12,3,1,fail
18292,2,True,1,1,2,1,1,fail
18293,1,True,1,1,2,1,1,fail
18295,1,False,1,1,2,1,1,fail
18296,1,False,3,1,4,2,2,fail
18297,1,False,7,16,23,1,1,fail
18299,1,False,7,6,13,1,1,fail
18300,1,False,5,5,10,1,1,fail
18301,1,False,4,4,8,1,1,fail
18302,1,False,3,23,26,1,1,fail
18303,1,False,4,1,5,1,1,fail
18304,2,True,23,3,26,1,1,fail
18305,2,True,1,1,2,1,1,fail
18307,1,False,1,0,1,1,1,fail
18308,1,False,3,1,4,2,2,fail
18309,1,False,2,6,8,1,1,fail
18310,1,False,7,13,20,1,1,fail
18311,1,False,4,0,4,1,1,fail
18313,1,False,2,2,4,2,2,fail
18314,1,False,1,0,1,1,1,fail
18315,1,False,6,1,7,2,1,fail
18316,2,True,92,28,120,6,3,fail
18318,1,False,2,0,2,1,1,fail
18320,1,False,1,1,2,1,1,fail
18322,1,False,2,0,2,1,1,fail
18324,1,False,4,4,8,2,1,fail
18325,1,False,1,1,2,1,1,fail
18326,1,False,6,6,12,3,1,fail
18328,1,False,3,0,3,1,1,fail
18329,1,False,30,13,43,1,1,fail
18330,1,False,29,19,48,1,1,fail
18331,1,False,7,5,12,1,1,fail
18332,1,False,1,1,2,1,1,fail
18333,1,False,31,4,35,1,1,fail
18334,2,True,39,12,51,7,5,fail
18338,1,False,1,1,2,1,1,fail
18339,1,False,3,1,4,1,1,fail
18340,1,False,1,1,2,1,1,fail
18341,1,False,30,8,38,4,4,fail
18342,1,False,5,5,10,1,1,fail
18343,1,False,5,1,6,1,1,fail
18344,1,False,7,3,10,2,1,fail
18345,1,False,8,8,16,1,1,fail
18346,1,False,1,1,2,1,1,fail
18347,1,False,4,4,8,3,2,fail
18348,1,False,378,7,385,4,3,fail
18349,1,False,6,6,12,2,1,fail
18350,1,False,5,166,171,3,3,fail
18351,1,False,2,5,7,1,1,fail
18352,1,False,1,1,2,1,1,fail
18353,1,False,0,1,1,1,1,fail
18354,1,False,150,49,199,3,3,fail
18355,1,False,1,0,1,1,1,fail
18356,1,False,15,37,52,2,1,fail
18357,1,False,2,6,8,1,1,fail
18358,1,False,5,0,5,1,1,fail
18360,1,False,38,12,50,3,1,fail
18362,1,False,3,1,4,2,2,pass
18364,1,True,4,3,7,1,1,pass
18365,1,False,1,1,2,1,1,fail
18366,1,False,3,0,3,2,2,fail
18367,1,False,7,3,10,2,1,fail
18368,1,False,5,2,7,3,2,pass
18370,2,False,2,2,4,2,1,pass
18372,1,False,1,1,2,1,1,pass
18373,1,False,1,1,2,1,1,pass
18374,1,False,1,1,2,1,1,pass
18375,1,False,1,1,2,1,1,pass
18376,1,False,1,1,2,1,1,pass
18377,1,False,1,0,1,1,1,pass
18379,1,False,12,5,17,3,2,pass
18380,1,False,1,1,2,1,1,pass
18381,2,True,1224,7,1231,8,2,pass
18382,1,False,2,2,4,1,1,fail
18383,1,True,5,5,10,1,1,pass
18384,1,True,1,1301,1302,6,1,fail
18385,1,False,2,2,4,1,1,fail
18386,1,False,8,0,8,1,1,fail
18387,1,True,13,14,27,7,1,pass
18388,1,True,6,6,12,1,1,fail
18391,1,True,1220,7,1227,8,2,fail
18392,2,True,377,17,394,3,2,fail
18393,1,False,12,4,16,1,1,fail
18394,1,False,44,2,46,3,2,fail
18395,1,False,1,1,2,1,1,fail
18396,1,False,3,2,5,2,2,fail
18397,1,False,1,1,2,1,1,fail
18398,1,False,11,7,18,3,2,fail
18399,1,False,16,8,24,1,1,fail
18400,1,False,2,0,2,1,1,fail
18401,1,False,2,0,2,1,1,fail
18402,1,False,2,0,2,1,1,fail
18403,2,True,1,1,2,1,1,fail
18404,1,True,1,1,2,1,1,fail
18405,1,True,1,1,2,1,1,fail
18406,2,True,1,1,2,1,1,fail
18407,1,True,1,1,2,1,1,fail
18408,1,True,3,4,7,1,1,fail
18409,1,True,1,1,2,1,1,fail
18410,1,True,0,0,0,1,1,fail
18412,1,True,2,2,4,1,1,fail
18413,1,True,85,0,85,1,1,fail
18414,1,True,5,5,10,1,1,fail
18415,1,True,5,5,10,1,1,fail
18416,1,True,0,8,8,1,1,fail
18419,1,True,19,3,22,1,1,fail
18420,1,True,52,7,59,1,1,fail
18421,1,True,1,1,2,1,1,fail
18423,2,True,61,19,80,14,6,fail
18424,1,True,1,0,1,1,1,fail
18425,1,False,1,0,1,1,1,fail
18426,1,False,3,1,4,2,2,fail
18427,1,False,2,1,3,1,1,fail
18428,2,True,32,2,34,4,3,fail
18429,1,True,2,19,21,2,2,fail
18430,1,True,1,1,2,1,1,fail
18431,1,True,24,1,25,3,3,fail
18432,1,True,26,2,28,3,3,pass
18433,1,False,4,3,7,2,1,pass
18434,1,False,1,1,2,1,1,pass
18435,2,True,13,8,21,5,3,pass
18436,1,True,2,2,4,1,1,pass
18437,1,True,2,1,3,1,1,fail
18438,1,True,1,1,2,1,1,pass
18439,1,True,3,2,5,1,1,fail
18440,1,True,10,11,21,1,1,fail
18441,1,True,1,3,4,1,1,pass
18442,1,True,4,2,6,1,1,pass
18443,1,False,1,0,1,1,1,pass
18444,1,False,1,1,2,1,1,pass
18446,1,False,3,1,4,2,2,fail
18447,1,False,1,1,2,1,1,fail
18448,1,False,2,2,4,1,1,pass
18449,1,True,10,24,34,1,1,pass
18450,1,True,28,11,39,1,1,pass
18451,1,True,7,10,17,1,1,pass
18452,1,True,2,2,4,1,1,fail
18453,1,True,7,16,23,1,1,fail
18454,1,True,10,5,15,1,1,pass
18455,1,True,4,0,4,1,1,pass
18456,1,True,1,2,3,2,1,pass
18457,1,True,3,5,8,4,2,fail
18458,1,True,9,6,15,1,1,fail
18459,1,True,9,5,14,2,2,fail
18460,1,False,3,1,4,2,2,pass
18461,1,False,4,1,5,1,1,pass
18462,1,False,12,0,12,1,1,pass
18463,1,False,4,2,6,1,1,pass
18464,1,False,1,1,2,1,1,pass
18465,1,False,1,1,2,2,2,pass
18466,1,False,1,0,1,1,1,fail
18468,1,False,1,1,2,1,1,fail
18469,1,False,1,1,2,1,1,fail
18470,2,False,0,0,0,0,0,fail
18472,1,False,1,0,1,1,1,fail
18473,2,True,0,1,1,1,1,fail
18474,1,True,0,1,1,1,1,fail
18475,1,False,0,1,1,1,1,fail
18476,1,False,3,0,3,1,1,fail
18478,1,False,1,11,12,1,1,fail
18479,1,False,1,0,1,1,1,fail
18480,1,False,1,1,2,1,1,fail
18481,1,False,2,1,3,1,1,fail
18482,1,False,1,0,1,1,1,fail
18483,1,False,1,1,2,1,1,fail
18484,1,False,12,12,24,1,1,fail
18485,1,False,1,1,2,1,1,fail
18486,1,False,0,1,1,1,1,fail
18487,1,False,4,4,8,3,1,fail
18488,1,False,38,8,46,5,2,fail
18489,1,False,10,1,11,2,1,fail
18490,1,False,8,3,11,2,1,fail
18491,1,False,46,57,103,4,4,fail
18492,1,False,1,1,2,1,1,fail
18493,1,False,1,0,1,1,1,fail
18494,2,False,0,0,0,0,0,fail
18496,1,False,99,40,139,2,1,fail
18497,2,True,5,11,16,2,2,fail
18498,1,True,0,1,1,1,1,fail
18499,1,True,1,6,7,1,1,fail
18500,1,True,2,2,4,1,1,fail
18501,1,True,1,2,3,1,1,fail
18502,1,True,5,4,9,2,2,fail
18503,1,False,3,1,4,1,1,fail
18504,1,False,1,1,2,1,1,fail
18505,1,False,1,1,2,1,1,fail
18506,1,False,1,1,2,1,1,fail
18507,1,False,2,1,3,1,1,fail
18508,1,False,3,0,3,1,1,fail
18509,1,False,57,20,77,3,3,fail
18510,1,False,1,1,2,1,1,fail
18511,1,False,90632,18,90650,226,5,fail
18513,1,False,1,1,2,1,1,fail
18514,1,False,1,1,2,1,1,fail
18543,1,True,2,18,20,1,1,pass
18552,1,True,28,25,53,1,1,pass
18556,1,True,6,0,6,1,1,pass
18559,1,True,36,0,36,1,1,fail
18560,1,True,3,4,7,1,1,pass
18561,1,True,3,1,4,1,1,pass
18562,1,True,5,2,7,1,1,pass
18570,1,True,3,0,3,1,1,pass
18572,1,True,0,1,1,1,1,pass
18573,1,True,2,4,6,2,1,pass
18574,2,True,31,0,31,1,1,pass
18575,1,True,31,0,31,1,1,fail
18576,1,True,3,1,4,1,1,pass
18586,1,True,1,1,2,1,1,pass
18588,1,True,20,0,20,1,1,pass
18590,1,True,0,1,1,1,1,pass
18594,1,True,4,1,5,2,1,pass
18595,1,True,5,0,5,1,1,fail
18598,1,True,1,1,2,1,1,pass
18599,1,True,10,1,11,2,1,fail
18610,1,True,0,7,7,1,1,pass
18614,1,True,1,1,2,1,1,fail
18616,1,True,1,0,1,1,1,fail
18618,1,True,0,0,0,0,0,pass
18619,1,True,2,2,4,1,1,fail
18620,1,True,143,0,143,2,2,fail
18621,1,True,1,0,1,1,1,fail
18622,1,True,0,1,1,1,1,fail
18623,1,True,1,0,1,1,1,fail
18624,1,True,35,143,178,3,3,fail
18625,2,True,2,2,4,2,1,pass
18626,1,True,2,2,4,2,1,fail
18627,1,False,1,2,3,1,1,pass
18628,2,True,66,36,102,11,5,pass
18629,1,True,54,19,73,5,5,fail
18632,1,False,3,1,4,2,2,pass
18634,1,False,5,2,7,2,2,pass
18635,2,True,209,28,237,3,2,pass
18636,2,True,6,21,27,4,1,fail
18637,1,False,1,1,2,1,1,pass
18638,1,False,4,19,23,2,1,fail
18639,1,True,1,4,5,3,3,pass
18640,1,True,205,28,233,4,3,fail
18641,1,True,8,1,9,1,1,pass
18642,2,True,1,1,2,1,1,pass
18643,1,True,1,1,2,1,1,pass
18644,1,False,2,0,2,1,1,pass
18645,2,True,36,13,49,2,1,fail
18646,1,True,36,13,49,2,1,pass
18647,2,False,22,27,49,10,7,pass
18649,1,False,1,1,2,1,1,pass
18650,1,False,0,7,7,4,3,pass
18651,1,False,10,14,24,3,3,pass
18652,2,True,1,1,2,1,1,fail
18653,1,True,1,1,2,1,1,fail
18654,1,False,1,1,2,1,1,fail
18655,1,False,5,0,5,1,1,fail
18656,1,False,1,1,2,1,1,fail
18657,1,False,2,2,4,1,1,fail
18658,1,False,2,2,4,1,1,fail
18659,1,False,1,0,1,1,1,fail
18660,1,False,2,2,4,1,1,fail
18661,1,False,1,1,2,1,1,fail
18662,1,False,1,1,2,1,1,fail
18663,1,False,1,1,2,1,1,fail
18664,1,False,6,3,9,2,2,fail
18665,2,True,36,56,92,2,2,fail
18666,2,True,1,1,2,1,1,pass
18667,1,True,1,1,2,1,1,pass
18668,1,False,41,1,42,1,1,pass
18669,2,True,1,1,2,1,1,pass
18670,1,True,16,45,61,1,1,pass
18672,1,True,1,1,2,1,1,pass
18673,2,True,10,16,26,1,1,pass
18674,1,True,10,16,26,1,1,pass
18675,1,False,2,0,2,1,1,pass
18676,1,False,3,1,4,2,2,pass
18677,1,False,8,0,8,1,1,pass
18678,1,False,1,1,2,1,1,pass
18679,1,False,4,4,8,1,1,pass
18680,1,False,4,4,8,1,1,fail
18681,2,True,1,1,2,1,1,fail
18682,1,False,7,0,7,1,1,fail
18683,1,True,1,1,2,1,1,fail
18684,1,False,51,22,73,2,2,fail
18686,2,True,11,8,19,1,1,fail
18687,2,True,95,6,101,4,2,fail
18688,1,True,2,0,2,1,1,fail
18689,1,True,20,7,27,1,1,fail
18690,1,True,13,5,18,1,1,fail
18691,1,False,0,4,4,1,1,fail
18692,1,False,1,1,2,1,1,fail
18693,1,False,5,0,5,1,1,fail
18695,2,True,289,1,290,3,3,fail
18696,1,True,289,1,290,3,3,pass
18697,1,False,1,0,1,1,1,fail
18698,2,True,7,19,26,1,1,pass
18699,1,True,67,1,68,3,1,fail
18700,2,True,7,3,10,1,1,pass
18701,1,True,7,3,10,1,1,fail
18702,1,True,11,8,19,1,1,fail
18703,1,False,2,2,4,1,1,pass
18704,1,False,10,10,20,3,1,pass
18705,1,False,1,1,2,1,1,pass
18707,1,False,1,0,1,1,1,pass
18708,1,True,1,1,2,1,1,pass
18709,1,True,5,5,10,1,1,pass
18711,1,False,1,0,1,1,1,pass
18712,2,True,6,2,8,2,1,pass
18713,1,False,4,0,4,1,1,pass
18715,1,False,6,2,8,1,1,pass
18716,2,True,2,2,4,1,1,pass
18717,1,True,2,2,4,1,1,pass
18718,1,True,6,2,8,2,1,pass
18719,1,False,8,7,15,1,1,pass
18720,1,False,1,1,2,1,1,pass
18721,1,False,2,2,4,1,1,pass
18722,1,False,48,16,64,2,2,fail
18723,2,True,0,8334,8334,13,2,pass
18724,1,True,0,8334,8334,13,2,pass
18725,1,False,1,1,2,1,1,pass
18726,1,False,3,1,4,2,2,pass
18728,1,False,13,0,13,1,1,pass
18729,1,False,1,0,1,1,1,pass
18730,1,False,1,1,2,1,1,pass
18731,1,False,3,0,3,1,1,pass
18732,2,True,24,4,28,1,1,pass
18733,1,True,24,4,28,1,1,pass
18734,2,True,7,5,12,2,2,pass
18735,1,True,7,5,12,2,2,pass
18736,1,False,1,1,2,1,1,pass
18737,1,False,1,1,2,1,1,pass
18738,2,True,10,7,17,1,1,pass
18739,1,True,4,3,7,1,1,pass
18740,1,True,3,0,3,1,1,pass
18743,2,True,1,1,2,1,1,pass
18744,1,True,1,1,2,1,1,pass
18745,1,False,2,2,4,1,1,pass
18746,1,False,1,1,2,1,1,pass
18747,1,False,11,39,50,2,2,pass
18748,2,False,12753,1,12754,33,2,pass
18750,1,False,2,1,3,2,1,pass
18751,1,False,883,0,883,5,2,pass
18752,1,False,11868,0,11868,26,1,pass
18753,1,False,3,0,3,1,1,pass
18754,1,False,1,1,2,1,1,pass
18755,1,False,1,1,2,1,1,pass
18756,1,False,3,0,3,1,1,fail
18757,1,False,7,1,8,2,1,fail
18758,1,False,8,8,16,1,1,pass
18759,1,False,17,0,17,1,1,pass
18760,2,True,7,9,16,1,1,pass
18761,1,True,7,9,16,1,1,pass
18762,1,False,13,15,28,1,1,pass
18763,1,False,1,0,1,1,1,pass
18764,1,False,40,1,41,2,2,pass
18765,1,False,101,129,230,2,2,pass
18766,1,False,1,0,1,1,1,pass
18767,1,False,3,1,4,2,2,pass
18768,2,False,21,11,32,4,2,pass
18770,2,True,20,11,31,2,1,pass
18771,1,True,20,11,31,2,1,pass
18772,1,False,1,0,1,2,1,pass
18773,1,False,9,4,13,2,2,pass
18774,1,False,24,11,35,2,2,fail
18775,1,False,17,6,23,3,1,fail
18776,1,False,105904,113,106017,221,11,fail
18777,1,False,0,10,10,2,1,pass
18780,1,False,0,1,1,1,1,pass
18781,1,False,17,10,27,1,1,pass
18782,1,False,237,57,294,2,2,pass
18783,1,False,8,0,8,1,1,pass
18785,1,False,63,231,294,4,3,pass
18786,1,False,4,0,4,1,1,pass
18787,1,False,150,150,300,1,1,pass
18788,2,True,1,1,2,1,1,pass
18789,1,True,1,1,2,1,1,pass
18790,2,True,19,3,22,2,1,pass
18791,1,True,3,1,4,1,1,pass
18792,1,True,16,2,18,1,1,pass
18793,1,False,1,1,2,1,1,pass
18795,2,True,340,131,471,8,3,pass
18796,2,True,4,0,4,1,1,pass
18797,2,True,3,3,6,1,1,pass
18798,1,True,3,3,6,1,1,pass
18799,1,True,4,0,4,1,1,pass
18800,1,True,1,1,2,1,1,pass
18801,1,True,49,49,98,2,2,pass
18802,1,True,84,0,84,2,1,pass
18804,1,True,2,2,4,1,1,pass
18806,1,True,11,2,13,1,1,pass
18812,2,True,1,1,2,1,1,pass
18813,1,True,1,1,2,1,1,fail
18814,1,False,1,1,2,1,1,pass
18815,1,False,3,1,4,1,1,pass
18816,2,True,47,14,61,3,1,pass
18817,1,True,9,2,11,1,1,pass
18818,1,True,30,3,33,3,1,pass
18820,1,False,3,6,9,2,2,pass
18821,2,True,62,2,64,2,1,pass
18822,1,True,6,7,13,1,1,pass
18823,1,False,2,1,3,2,2,pass
18824,1,False,9,1,10,1,1,pass
18825,1,True,51,1,52,1,1,pass
18827,1,False,1,0,1,1,1,pass
18828,1,False,38,28,66,3,3,pass
18829,1,False,3,1,4,1,1,pass
18830,1,False,1,1,2,1,1,pass
18831,1,False,15,0,15,1,1,pass
18832,1,False,1,1,2,1,1,pass
18833,1,False,2,2,4,1,1,pass
18834,1,False,3,3,6,1,1,pass
18835,2,False,75,14,89,6,4,pass
18837,2,True,1,1,2,1,1,pass
18838,1,True,1,1,2,1,1,pass
18839,1,False,4,0,4,1,1,pass
18840,2,True,69,9,78,4,2,pass
18841,1,True,8,11,19,1,1,pass
18842,2,True,1,1,2,1,1,pass
18843,1,True,1,1,2,1,1,pass
18844,1,False,3,0,3,1,1,pass
18846,1,False,4,0,4,1,1,pass
18847,1,False,2,2,4,2,2,pass
18848,1,True,57,1,58,1,1,pass
18852,1,False,0,4,4,1,1,pass
18853,1,False,1,1,2,1,1,pass
18855,2,True,413,217,630,12,3,pass
18856,1,True,59,0,59,1,1,pass
18857,1,True,1,2,3,2,1,pass
18858,2,True,22,17,39,6,2,pass
18859,1,True,4,6,10,1,1,pass
18860,1,True,43,10,53,2,1,pass
18863,1,True,8,16,24,2,1,pass
18866,1,False,7,3,10,1,1,pass
18869,1,False,2,0,2,1,1,pass
18870,1,False,1,6,7,2,1,pass
18871,2,True,10,7,17,4,1,pass
18872,1,False,1,0,1,1,1,pass
18873,1,True,0,0,0,1,1,fail
18874,1,False,1,1,2,1,1,pass
18883,1,True,1,1,2,1,1,pass
18884,1,True,1,1,2,1,1,pass
18885,1,True,12,9,21,5,1,fail
18888,2,True,5,0,5,1,1,pass
18889,1,True,5,0,5,1,1,pass
18890,1,False,2,2,4,1,1,pass
18891,1,False,2,1,3,1,1,pass
18892,1,False,10,5,15,1,1,pass
18893,1,False,2,1,3,2,2,pass
18894,1,False,22,3,25,1,1,pass
18895,1,False,9,1,10,2,2,pass
18898,1,False,2,2,4,2,1,pass
18899,1,False,78,0,78,2,1,pass
18900,1,False,15,10,25,2,1,pass
18901,1,False,2,1,3,1,1,pass
18902,1,False,19,7,26,1,1,pass
18903,1,False,2,2,4,1,1,pass
18904,1,False,2,2,4,1,1,pass
18905,1,False,10,1,11,1,1,pass
18906,1,False,3,1,4,2,1,pass
18907,1,False,2,0,2,1,1,pass
18908,1,False,2,1,3,1,1,pass
18909,1,False,1,1,2,1,1,pass
18910,1,False,7,7,14,4,2,pass
18911,2,True,15,1,16,4,3,pass
18912,1,True,15,1,16,4,3,pass
18913,1,False,4,0,4,1,1,pass
18914,1,False,1,0,1,1,1,pass
18916,1,False,1,1,2,1,1,pass
18917,1,False,3,1,4,2,2,pass
18918,1,False,1,1,2,1,1,pass
18919,1,False,23,0,23,1,1,pass
18920,2,False,2,2,4,2,1,pass
18922,1,False,1,1,2,1,1,pass
18923,1,False,1,1,2,1,1,pass
18924,1,False,23,14,37,2,2,pass
18927,1,False,12,2,14,1,1,fail
18929,1,False,1,1,2,1,1,pass
18930,1,False,2,1,3,1,1,fail
18931,1,False,1,1,2,1,1,fail
18932,1,False,10,8,18,3,2,fail
18934,1,False,11,11,22,1,1,pass
18936,1,False,1,1,2,1,1,pass
18938,1,False,18,0,18,1,1,pass
18939,1,False,0,1,1,1,1,pass
18940,1,False,13,7,20,3,2,fail
18941,1,False,2,1,3,1,1,pass
18942,1,False,5,1,6,1,1,pass
18943,1,False,18,6,24,3,1,pass
18944,1,False,18,10,28,3,1,pass
18945,1,False,1,1,2,1,1,pass
18946,1,False,29,4,33,2,2,pass
18947,1,False,2,2,4,1,1,pass
18948,1,False,1,1,2,1,1,pass
18949,1,False,9,2,11,3,2,pass
18950,1,False,2,0,2,1,1,pass
18951,1,False,1,1,2,1,1,pass
18952,1,False,7,15,22,1,1,fail
18953,1,False,1,1,2,1,1,pass
18954,1,False,1,1,2,1,1,pass
18955,1,False,1,1,2,1,1,pass
18956,1,False,10,2,12,1,1,pass
18957,1,False,0,11,11,1,1,pass
18958,1,False,5,3,8,2,2,pass
18959,1,False,0,1,1,1,1,fail
18960,1,False,1,1,2,1,1,fail
18962,1,False,5,1,6,1,1,fail
18963,1,False,3,2,5,2,2,fail
18964,1,False,3,3,6,2,1,fail
18965,2,True,1,1,2,1,1,fail
18966,1,False,20,11,31,1,1,fail
18967,1,False,1,1,2,1,1,fail
18968,1,False,8,2,10,1,1,fail
18969,1,False,5,0,5,1,1,fail
18970,1,False,19,0,19,1,1,fail
18971,1,False,1,1,2,1,1,fail
18972,1,False,76,40,116,1,1,fail
18974,1,False,0,4,4,1,1,fail
18976,1,False,1,4,5,1,1,fail
18978,1,False,16,8,24,3,2,fail
18979,1,True,1,1,2,1,1,pass
18980,1,False,2,1,3,1,1,fail
18981,1,False,1,1,2,1,1,pass
18983,1,False,2,0,2,1,1,pass
18984,2,True,50,14,64,2,1,pass
18985,1,True,50,14,64,2,1,pass
18986,1,False,22,1,23,3,1,pass
18987,1,False,2,2,4,1,1,pass
18989,1,False,3,0,3,1,1,pass
18990,1,False,4,4,8,1,1,pass
18991,1,False,1,1,2,1,1,pass
18992,1,False,7,7,14,1,1,pass
18993,1,False,3,3,6,1,1,pass
18994,1,False,1,1,2,1,1,pass
18995,1,False,2,2,4,1,1,pass
18996,1,False,1,1,2,1,1,pass
18997,1,False,1,0,1,1,1,pass
18998,1,False,4,2,6,1,1,pass
18999,1,False,42,1,43,1,1,pass
19000,1,False,2,1,3,2,2,pass
19001,2,True,6,0,6,1,1,pass
19002,1,True,0,1,1,1,1,fail
19003,1,True,7,0,7,1,1,pass
19004,1,False,1,0,1,1,1,pass
19005,1,False,10,8,18,1,1,pass
19006,2,True,128,0,128,4,3,pass
19007,2,True,6,4,10,1,1,pass
19008,1,True,19,17,36,2,1,pass
19009,1,False,2,2,4,1,1,pass
19010,1,True,3,0,3,1,1,pass
19012,1,True,12,13,25,1,1,pass
19013,1,True,20,17,37,1,1,pass
19014,1,False,1,0,1,1,1,pass
19015,1,False,1,2,3,1,1,fail
19016,1,False,2,0,2,1,1,pass
19017,2,True,5,3,8,1,1,pass
19018,1,True,5,3,8,1,1,pass
19019,1,False,6,0,6,1,1,pass
19020,1,False,1,1,2,1,1,pass
19021,1,False,164,2,166,5,3,pass
19022,1,False,10,5,15,1,1,pass
19023,1,False,0,4,4,2,1,pass
19024,1,False,119,2,121,1,1,pass
19025,1,False,58,13,71,2,2,pass
19027,1,False,2,1,3,2,2,pass
19028,1,False,7,7,14,1,1,pass
19029,1,False,1,0,1,1,1,pass
19030,1,False,4,1,5,1,1,pass
19031,2,True,2,5,7,1,1,pass
19032,1,False,1,1,2,1,1,pass
19033,1,False,2,0,2,1,1,pass
19034,1,False,3,0,3,1,1,pass
19035,2,True,1,1,2,1,1,pass
19036,1,True,1,1,2,1,1,pass
19037,1,True,2,5,7,1,1,pass
19038,1,False,4,4,8,1,1,pass
19040,1,False,33,33,66,1,1,pass
19041,1,False,1,1,2,1,1,pass
19043,1,False,10,7,17,1,1,pass
19044,2,True,1,1,2,1,1,pass
19045,1,True,1,1,2,1,1,pass
19046,1,False,3,1,4,2,2,fail
19047,1,False,4,0,4,1,1,fail
19048,1,False,1,1,2,1,1,pass
19049,2,True,16,11,27,2,1,pass
19050,1,True,9,6,15,1,1,pass
19053,1,False,2,0,2,1,1,pass
19054,2,True,18,6,24,2,1,pass
19055,1,True,18,6,24,2,1,pass
19056,1,False,3,1,4,2,2,pass
19057,1,False,1,1,2,1,1,pass
19058,1,False,1,1,2,1,1,fail
19061,2,True,12,2,14,1,1,fail
19062,1,False,1,0,1,1,1,fail
19063,1,False,35,24,59,1,1,fail
19064,1,True,12,2,14,1,1,fail
19065,1,False,3,1,4,2,2,pass
19066,1,False,3,0,3,1,1,pass
19067,2,True,31,27,58,4,2,pass
19068,2,True,1,1,2,1,1,pass
19069,2,True,17,3,20,1,1,pass
19070,2,True,1,1,2,1,1,pass
19071,1,True,1,1,2,1,1,fail
19072,1,True,2,0,2,1,1,pass
19073,1,True,2,2,4,1,1,pass
19078,1,True,1,1,2,1,1,pass
19079,1,True,17,3,20,1,1,pass
19080,2,True,2,2,4,1,1,pass
19081,1,False,3,1,4,2,2,pass
19082,1,False,2,2,4,1,1,pass
19083,1,True,2,2,4,1,1,fail
19084,1,False,3,1,4,2,2,pass
19085,1,False,29,1,30,2,1,pass
19086,1,False,3,1,4,2,2,pass
19087,1,False,1,1,2,1,1,pass
19088,1,False,1,1,2,1,1,fail
19089,1,False,0,1,1,1,1,fail
19090,1,False,28,9,37,7,4,fail
19093,1,False,77,61,138,2,2,fail
19094,1,False,1,0,1,1,1,fail
19095,1,False,1,1,2,1,1,fail
19096,1,False,1,0,1,1,1,fail
19097,2,True,33,11,44,7,4,fail
19098,1,False,1,1,2,1,1,pass
19099,2,True,9,2,11,2,2,pass
19100,1,True,9,2,11,2,2,fail
19101,1,True,1,1,2,1,1,pass
19102,1,False,1,1,2,1,1,pass
19103,1,False,1,1,2,1,1,fail
19104,1,True,3,1,4,1,1,pass
19105,1,False,2,4,6,1,1,fail
19106,1,False,3,1,4,1,1,fail
19107,1,False,2,1,3,1,1,fail
19109,1,False,9,0,9,1,1,fail
19110,1,False,1,0,1,1,1,fail
19111,1,False,1,0,1,1,1,fail
19112,1,False,4,0,4,2,1,fail
19113,2,True,6,6,12,3,3,pass
19119,1,True,4,4,8,1,1,pass
19127,2,True,4,2,6,2,2,pass
19128,2,True,44,39,83,2,2,pass
19129,1,True,4,2,6,2,2,pass
19130,1,True,44,39,83,2,2,pass
19131,2,True,1,1,2,1,1,fail
19132,1,True,1,1,2,1,1,fail
19133,1,False,2,1,3,1,1,fail
19139,2,True,4,2,6,3,3,pass
19140,1,True,0,1,1,1,1,pass
19142,1,False,38,1,39,2,2,fail
19144,2,True,8,11,19,2,1,pass
19145,1,True,8,11,19,2,1,pass
19146,1,False,2,1,3,2,2,fail
19147,2,True,16,7,23,1,1,fail
19148,2,True,2,0,2,1,1,fail
19149,1,False,1,1,2,1,1,fail
19150,1,False,4,5,9,1,1,fail
19151,1,False,9,5,14,1,1,fail
19152,1,False,1,0,1,1,1,fail
19154,1,False,7,8,15,2,2,fail
19155,1,True,2,0,2,1,1,fail
19156,1,True,16,7,23,1,1,fail
19158,1,False,5,4,9,1,1,fail
19159,1,False,4,3,7,2,2,fail
19160,1,False,4,2,6,1,1,fail
19162,1,False,9,9,18,2,2,fail
19164,1,False,3,1,4,2,2,pass
19165,1,False,6,0,6,1,1,pass
19167,1,False,1,0,1,1,1,pass
19168,1,False,3,1,4,2,2,pass
19169,2,True,20,33,53,1,1,pass
19170,2,True,22,6,28,1,1,pass
19171,2,True,3,1,4,1,1,pass
19172,1,True,2,2,4,1,1,pass
19173,1,True,18,8,26,1,1,pass
19174,1,True,3,1,4,1,1,pass
19175,1,True,9,3,12,1,1,pass
19176,2,True,3,4,7,1,1,pass
19177,1,True,1,1,2,1,1,pass
19178,1,True,3,4,7,1,1,fail
19179,1,True,20,33,53,1,1,pass
19180,2,True,0,2,2,1,1,pass
19181,1,True,0,2,2,1,1,pass
19182,1,False,3,1,4,2,2,pass
19183,1,False,2,3,5,1,1,pass
19184,2,True,6,2,8,1,1,pass
19185,2,True,497,159,656,15,6,fail
19187,1,False,1,1,2,1,1,pass
19188,1,False,3,0,3,1,1,fail
19189,1,False,2,2,4,1,1,fail
19190,1,False,17,0,17,1,1,fail
19191,1,False,3,1,4,2,2,fail
19192,1,False,4,2,6,2,1,fail
19193,1,False,40,1,41,2,1,pass
19194,1,False,6,1,7,2,2,pass
19195,1,False,3,3,6,2,1,pass
19196,2,True,7,1,8,1,1,pass
19197,2,True,41,33,74,9,1,pass
19198,2,True,1,1,2,1,1,pass
19199,2,True,1,1,2,1,1,pass
19200,1,True,7,1,8,1,1,fail
19201,1,True,1,1,2,1,1,pass
19202,1,True,41,33,74,9,1,pass
19203,1,True,1,1,2,1,1,pass
19204,1,False,4,2,6,3,2,pass
19205,2,True,1,1,2,1,1,pass
19206,1,True,1,1,2,1,1,pass
19207,1,False,1,1,2,1,1,pass
19209,2,True,2,2,4,1,1,pass
19210,1,True,2,2,4,1,1,pass
19211,1,False,0,1,1,1,1,pass
19212,1,False,0,3,3,1,1,pass
19213,1,False,1,0,1,1,1,pass
19214,1,False,1,1,2,1,1,fail
19215,1,False,3,1,4,2,2,fail
19217,1,False,3,1,4,2,2,fail
19219,1,False,3,1,4,2,2,fail
19220,1,False,1,1,2,1,1,fail
19221,1,False,3,1,4,1,1,fail
19223,1,False,32,4,36,4,3,fail
19224,1,False,1,1,2,1,1,fail
19226,1,False,60,61,121,2,2,fail
19227,1,False,2,2,4,1,1,fail
19228,1,False,4,2,6,1,1,fail
19229,1,False,0,0,0,0,0,fail
19230,1,False,1,1,2,1,1,fail
19232,1,False,1,1,2,1,1,fail
19233,1,False,6,29,35,1,1,fail
19234,1,False,1,1,2,1,1,fail
19236,1,False,2,1,3,1,1,fail
19237,1,False,1,0,1,1,1,fail
19238,1,False,5,5,10,2,2,fail
19241,2,True,4,0,4,1,1,fail
19242,1,False,3,1,4,2,2,fail
19243,1,False,23,5,28,1,1,fail
19247,1,True,4,0,4,1,1,fail
19248,1,False,1,1,2,1,1,fail
19249,1,False,1,0,1,1,1,fail
19250,1,False,1,1,2,1,1,pass
19251,1,False,12,8,20,2,2,pass
19252,1,False,34,12,46,2,1,pass
19255,2,True,1,1,2,1,1,pass
19256,1,True,1,1,2,1,1,fail
19257,1,False,4,1,5,2,2,pass
19259,1,False,1,0,1,1,1,pass
19260,1,False,1,0,1,1,1,pass
19261,1,False,1,1,2,1,1,pass
19262,1,False,1,1,2,1,1,fail
19263,1,False,2,2,4,1,1,fail
19264,1,False,1,0,1,1,1,fail
19265,2,True,205,45,250,6,4,fail
19266,1,True,1,1,2,1,1,fail
19269,1,True,5,5,10,1,1,fail
19273,2,True,6,21,27,3,2,pass
19274,1,False,1,1,2,1,1,pass
19278,1,True,0,1,1,1,1,pass
19279,1,True,13,1,14,2,1,pass
19280,1,True,4,10,14,1,1,pass
19281,1,True,113,13,126,2,1,pass
19282,1,True,4,2,6,1,1,pass
19283,1,False,3,1,4,2,2,pass
19284,1,False,1,1,2,1,1,pass
19285,2,True,1,1,2,1,1,pass
19286,1,True,1,1,2,1,1,fail
19287,1,True,1,1,2,1,1,pass
19288,1,False,0,2,2,1,1,pass
19289,1,False,1,1,2,1,1,pass
19290,1,False,3,2,5,2,2,pass
19291,1,False,66,6,72,2,1,pass
19292,1,False,1,1,2,1,1,pass
19293,1,False,1,1,2,1,1,pass
19295,1,False,42,35,77,1,1,pass
19296,1,False,8,9,17,3,3,pass
19297,1,False,17,1,18,1,1,fail
19299,1,False,8,3,11,3,1,fail
19300,1,False,2,1,3,1,1,pass
19301,1,False,1,2,3,1,1,pass
19302,1,False,3,1,4,1,1,pass
19307,1,False,7,3,10,2,2,pass
19308,1,False,20,22,42,1,1,pass
19309,1,False,17,3,20,2,1,pass
19310,1,False,3,3,6,2,1,pass
19311,1,False,1,1,2,1,1,pass
19312,1,False,1,0,1,1,1,pass
19313,1,False,7,1,8,3,2,pass
19314,1,False,10,5,15,2,2,pass
19317,1,False,3,3,6,1,1,pass
19318,1,False,15,8,23,3,3,pass
19319,1,False,1,1,2,1,1,pass
19320,1,False,9,1,10,3,2,pass
19324,1,False,1,1,2,1,1,pass
19325,1,False,4,6,10,1,1,pass
19326,1,False,6,0,6,1,1,pass
19327,1,False,10,4,14,3,2,pass
19328,1,False,9,4,13,2,1,pass
19329,2,True,28,1,29,1,1,pass
19330,2,True,9,9,18,4,3,pass
19332,1,True,6,2,8,1,1,pass
19333,1,True,24,1,25,1,1,pass
19334,2,True,4,4,8,2,2,pass
19335,2,True,21,1,22,5,2,pass
19336,2,True,3,1,4,1,1,pass
19337,2,True,0,2,2,1,1,pass
19338,1,True,0,2,2,1,1,pass
19339,1,True,3,1,4,1,1,pass
19340,1,True,2,2,4,1,1,pass
19341,1,True,2,2,4,1,1,fail
19342,1,True,21,1,22,5,2,pass
19343,1,False,4,2,6,3,2,pass
19344,1,False,0,1,1,1,1,pass
19345,2,True,9,1,10,3,2,fail
19346,1,True,1,0,1,1,1,fail
19348,1,False,3,1,4,1,1,pass
19351,1,False,2,0,2,1,1,pass
19352,2,True,2,8,10,1,1,pass
19353,1,True,2,8,10,1,1,pass
19354,1,False,3,0,3,1,1,pass
19355,1,False,9,1,10,1,1,pass
19356,1,False,5,1,6,1,1,pass
19357,1,False,2,0,2,1,1,pass
19358,1,False,1,0,1,1,1,pass
19359,1,False,2,2,4,2,1,pass
19362,1,False,9,8,17,1,1,pass
19364,1,False,5,3,8,3,2,pass
19368,1,False,3,0,3,1,1,pass
19369,1,False,13,1,14,1,1,pass
19370,1,False,6,0,6,1,1,pass
19371,1,False,3,0,3,1,1,pass
19372,1,False,28,4,32,1,1,pass
19373,1,False,10,2,12,2,1,pass
19374,1,False,1,0,1,1,1,pass
19378,1,False,2,1,3,1,1,pass
19379,1,False,5,1,6,1,1,pass
19380,1,False,9,3,12,1,1,pass
19381,1,False,1,1,2,1,1,pass
19382,1,False,9,2,11,1,1,pass
19383,1,False,1,0,1,1,1,pass
19384,1,False,0,0,0,0,0,fail
19389,1,False,2,2,4,2,1,fail
19541,1,False,16,13,29,2,1,fail
19542,2,True,1,1,2,1,1,pass
19543,2,True,41,45,86,8,2,pass
19544,1,True,1,1,2,1,1,fail
19545,1,True,19,26,45,4,1,fail
19548,2,True,106,48,154,4,3,pass
19549,1,True,2,2,4,2,1,pass
19554,1,True,106,48,154,4,3,pass
19555,1,True,1,1,2,1,1,pass
19556,1,True,7,0,7,1,1,fail
19557,1,True,18,13,31,4,4,pass
19558,2,True,5,1,6,1,1,fail
19559,1,True,5,1,6,1,1,pass
19560,2,True,0,4,4,2,2,pass
19561,1,True,0,4,4,2,2,pass
19562,1,True,30,24,54,3,3,pass
19563,1,True,4,4,8,1,1,pass
19564,1,True,3,3,6,2,1,pass
19565,1,True,14,5,19,2,2,pass
19566,1,True,37,24,61,3,2,pass
19567,1,True,1,1,2,1,1,fail
19569,1,True,14,14,28,1,1,pass
19570,1,True,106,0,106,1,1,pass
19571,1,True,3,3,6,1,1,pass
19572,1,True,4,5,9,1,1,fail
19573,1,True,1,1,2,1,1,pass
19574,1,True,1,1,2,1,1,pass
19575,1,True,8,6,14,2,1,pass
19576,1,True,12,10208,10220,30,5,pass
19577,1,True,11,12,23,3,2,pass
19578,1,True,0,29,29,2,1,pass
19579,1,True,3,0,3,1,1,pass
19580,1,True,44,21,65,5,5,pass
19581,1,True,107,1,108,2,2,pass
19582,1,True,132,0,132,2,2,pass
19583,1,True,1,1,2,1,1,pass
19584,1,True,31,0,31,1,1,pass
19585,1,True,22,0,22,3,2,pass
19586,1,True,3,0,3,1,1,pass
19587,2,True,30,1,31,1,1,pass
19588,1,True,7,3,10,1,1,pass
19589,1,True,11614,0,11614,3,2,fail
19590,1,True,4314,0,4314,2,1,fail
19591,1,True,66,64,130,1,1,pass
19592,1,True,107,0,107,2,2,fail
19593,1,True,36,35,71,2,2,fail
19594,1,True,1,1,2,1,1,pass
19595,1,True,20,23,43,3,3,pass
19596,1,True,30,1,31,1,1,pass
19597,1,True,359,109,468,4,1,pass
19598,1,True,4,0,4,1,1,pass
19599,1,True,0,1,1,1,1,pass
19600,1,True,1,0,1,1,1,pass
19601,1,True,5,0,5,1,1,pass
19602,1,True,106,0,106,1,1,pass
19603,1,True,124,0,124,2,2,pass
19604,2,True,106,0,106,1,1,pass
19605,1,True,106,0,106,1,1,fail
19606,1,True,73,38,111,4,3,fail
19607,1,True,1931,3,1934,11,2,pass
19608,1,True,1,2,3,1,1,pass
19609,1,True,2,0,2,1,1,pass
19610,2,True,3,1,4,1,1,pass
19611,1,True,2,2,4,1,1,fail
19612,1,True,1,0,1,1,1,pass
19615,1,True,2,1,3,1,1,pass
19616,1,True,47,12,59,4,1,pass
19617,1,True,14,1,15,1,1,pass
19618,1,True,654,0,654,5,1,pass
19619,1,True,3909,0,3909,2,1,pass
19620,1,True,75,1,76,2,1,pass
19621,1,True,260,6,266,5,2,pass
19622,1,True,120,0,120,2,2,pass
19623,1,True,107,0,107,2,1,pass
19624,1,True,142,0,142,2,2,pass
19625,1,True,125,1,126,3,2,pass
19626,1,True,107,1,108,2,2,pass
19627,1,True,19,6,25,2,2,pass
19628,1,True,5,6,11,1,1,pass
19629,1,True,6,1,7,1,1,pass
19630,1,True,108,2,110,2,2,pass
19631,1,True,20,0,20,2,2,pass
19632,1,True,5,0,5,1,1,pass
19633,1,True,1,0,1,1,1,pass
19634,1,True,2,1,3,1,1,fail
19635,1,True,2,17,19,2,2,pass
19637,1,True,42,0,42,1,1,pass
19638,1,True,22,0,22,1,1,pass
19639,1,True,2,1,3,1,1,pass
19640,1,True,35,2,37,2,2,pass
19641,1,True,107,1,108,2,1,pass
19642,1,True,38,0,38,1,1,fail
19643,1,True,7,7,14,1,1,pass
19644,1,True,3,2,5,2,1,pass
19645,1,True,848,0,848,8,2,pass
19646,1,True,255,11,266,8,2,pass
19647,1,True,31,0,31,3,1,pass
19648,1,True,176,8,184,4,1,pass
19649,1,True,1,1,2,1,1,pass
19650,1,True,3,0,3,1,1,pass
19651,1,True,106,0,106,1,1,pass
19652,1,True,108,0,108,2,2,pass
19653,1,True,108,2,110,2,2,pass
19654,1,True,18,2,20,3,2,pass
19655,1,True,19,12,31,1,1,pass
19656,1,True,105,47,152,3,3,fail
19657,1,True,19,2,21,3,2,pass
19658,1,True,1,2,3,1,1,pass
19659,1,True,13,1,14,2,1,pass
19660,1,True,106,0,106,1,1,pass
19661,1,True,62,1,63,2,1,pass
19662,1,True,133,1,134,3,2,pass
19663,1,True,2,0,2,1,1,pass
19664,1,True,1,1,2,1,1,pass
19665,1,True,8,8,16,1,1,pass
19667,1,True,1,1,2,1,1,pass
19668,1,True,107,1,108,2,1,pass
19669,1,True,1,1,2,1,1,pass
19670,1,True,107,0,107,2,2,pass
19671,1,True,18,7,25,3,2,pass
19672,1,True,1375,1707,3082,8,1,pass
19673,1,True,130,0,130,2,2,pass
19674,1,True,20,19,39,3,2,pass
19676,1,True,3,15,18,3,3,pass
19677,1,True,76,12,88,4,2,pass
19678,1,True,2,2,4,1,1,pass
19679,1,True,1,1,2,1,1,pass
19680,1,True,2,0,2,1,1,fail
19681,1,True,37,37,74,3,1,fail
19682,1,True,0,40,40,1,1,pass
19683,2,True,1,1,2,1,1,pass
19685,1,True,52,1,53,1,1,pass
19686,1,True,135,0,135,2,2,pass
19687,1,True,132,0,132,2,2,pass
19688,1,True,121,12,133,2,2,pass
19689,1,True,1,1,2,1,1,pass
19690,1,True,92,33,125,6,3,pass
19691,1,True,1,1,2,1,1,pass
19692,1,True,3,3,6,1,1,pass
19693,1,True,20,1,21,2,2,pass
19694,1,True,55,0,55,4,3,pass
19695,1,True,3,3,6,3,1,pass
19696,1,True,1,1,2,1,1,pass
19697,1,True,2,0,2,1,1,pass
19698,1,True,1,1,2,1,1,pass
19699,1,True,107,1,108,2,1,pass
19700,1,True,15,35,50,2,1,pass
19702,1,True,55,38,93,5,1,pass
19703,1,True,75,3,78,1,1,pass
19704,1,True,108,3,111,2,2,pass
19705,1,True,16,2,18,2,2,pass
19706,1,True,1,1,2,1,1,pass
19707,1,True,4,0,4,1,1,pass
19708,1,True,45,0,45,1,1,pass
19709,1,True,5,5,10,3,2,pass
19710,1,True,106,0,106,1,1,pass
19711,1,True,10,2,12,1,1,pass
19712,1,True,153,249,402,3,1,pass
19713,1,True,771,0,771,8,2,pass
19714,1,True,10,9,19,2,1,pass
19715,1,True,106,0,106,1,1,pass
19716,1,True,4,4,8,1,1,pass
19717,1,True,106,0,106,1,1,pass
19718,1,True,8,0,8,1,1,pass
19719,2,True,12,12,24,4,1,pass
19725,1,True,1,1,2,1,1,pass
19726,1,True,1,1,2,1,1,pass
19727,1,True,78,59,137,2,1,pass
19728,1,True,26,25,51,2,1,pass
19729,2,True,517,86,603,18,4,pass
19730,2,True,141,17,158,5,4,fail
19731,1,True,21,12,33,1,1,pass
19732,1,True,517,86,603,18,3,pass
19733,1,True,1,1,2,1,1,pass
19734,1,True,3,1,4,2,1,pass
19737,1,True,3,1,4,2,1,pass
19738,1,True,36,7,43,5,2,pass
19739,1,True,111,0,111,2,2,pass
19743,1,True,196,55,251,2,2,pass
19744,1,True,3,2,5,1,1,pass
19745,1,True,4,1,5,1,1,pass
19746,1,True,1,1,2,1,1,pass
19747,1,True,8,0,8,1,1,pass
19748,1,True,108,2,110,3,2,pass
19749,1,True,1,1,2,1,1,pass
19750,1,True,1,1,2,1,1,pass
19751,1,True,1,1,2,2,1,pass
19752,1,True,1,1,2,1,1,pass
19753,1,True,19,0,19,2,1,pass
19754,1,True,26,2,28,2,2,pass
19755,1,True,28,0,28,1,1,pass
19756,1,True,127,13,140,3,1,pass
19757,1,True,169,19,188,2,2,pass
19758,1,True,4,3,7,2,2,pass
19759,1,True,1,2,3,1,1,pass
19761,1,True,486,127,613,8,1,pass
19762,2,True,70,0,70,3,1,pass
19763,1,True,3,3,6,1,1,pass
19765,1,True,1,3,4,1,1,pass
19767,1,True,18,5,23,2,1,pass
19768,2,True,2,0,2,1,1,pass
19769,1,True,32,33,65,1,1,pass
19770,1,True,106,0,106,1,1,pass
19771,1,True,2,0,2,1,1,pass
19772,2,True,2,2,4,1,1,pass
19773,1,True,2,2,4,1,1,pass
19774,1,True,8,7,15,1,1,pass
19775,2,True,0,6,6,1,1,pass
19776,2,True,22,15,37,4,2,pass
19777,1,True,9,2,11,2,1,pass
19781,2,True,4,1,5,1,1,pass
19782,2,True,29,9,38,1,1,pass
19783,1,True,29,9,38,1,1,pass
19784,1,True,2,2,4,1,1,pass
19785,1,True,1,1,2,1,1,pass
19786,1,True,4,1,5,1,1,pass
19787,2,True,31,56,87,1,1,pass
19788,1,True,31,56,87,1,1,pass
19789,1,True,1,0,1,1,1,pass
19790,1,True,2,2,4,1,1,pass
19791,2,True,6,6,12,4,4,pass
19792,2,True,25,1,26,2,2,pass
19793,1,True,1,1,2,1,1,pass
19794,1,True,6,6,12,4,4,fail
19795,1,True,136,0,136,2,2,pass
19796,1,True,25,1,26,2,2,pass
19798,1,True,107,1,108,2,1,pass
19799,2,True,27,10,37,5,1,pass
19800,2,True,88,45,133,10,4,pass
19801,1,True,27,10,37,5,1,pass
19802,1,True,67,83,150,1,1,pass
19803,2,True,10,0,10,3,2,pass
19804,1,True,51,44,95,7,4,pass
19806,1,True,10,0,10,3,2,pass
19807,2,True,266,11,277,6,3,pass
19808,2,True,13,0,13,2,1,pass
19809,1,True,118,24,142,2,2,pass
19810,2,True,2,2,4,2,1,pass
19811,1,True,2,2,4,2,1,pass
19812,2,True,51,60,111,9,1,pass
19813,1,True,26,22,48,2,2,pass
19814,1,True,13,0,13,2,1,pass
19815,1,True,10,20,30,4,3,pass
19816,1,True,15,15,30,7,1,pass
19817,2,True,361,149,510,61,4,fail
19819,1,True,1,0,1,1,1,pass
19820,2,True,25,6,31,2,1,pass
19821,2,True,11,11,22,1,1,pass
19822,2,True,325,138,463,57,4,pass
19823,2,True,11,19,30,2,1,pass
19826,1,True,10,14,24,1,1,pass
19828,1,True,1,1,2,1,1,pass
19831,1,True,138,81,219,45,1,pass
19833,2,True,143,0,143,2,2,pass
19834,2,True,22,13,35,2,2,pass
19835,1,True,43,31,74,7,1,pass
19838,1,True,14,5,19,1,1,pass
19839,1,True,17,13,30,1,1,pass
19840,1,True,23,0,23,2,1,pass
19841,1,True,5,0,5,1,1,pass
19842,1,True,7,8,15,1,1,pass
19843,1,True,12,12,24,1,1,pass
19844,1,True,6,11,17,1,1,pass
19845,1,True,4,4,8,1,1,pass
19849,1,True,59,13,72,4,2,pass
19850,1,True,32,7,39,6,2,pass
19852,1,True,161,6182,6343,45,3,pass
19853,2,True,129,3,132,3,2,pass
19854,1,True,109,3,112,2,2,pass
19855,1,True,8,7,15,2,1,pass
19857,1,True,2,12,14,1,1,pass
19858,1,True,2,0,2,2,1,pass
19859,1,True,106,0,106,1,1,pass
19862,1,True,298,2,300,21,3,pass
19865,1,True,5,5,10,2,1,pass
19866,1,True,1,1,2,1,1,pass
19867,2,True,24,23,47,2,2,pass
19868,1,True,6,3,9,1,1,pass
19869,1,True,113,1,114,2,2,pass
19870,1,True,29,0,29,2,1,pass
19873,1,True,3,3,6,1,1,pass
19874,1,True,46,26,72,8,4,pass
19876,1,True,1,1,2,1,1,pass
19877,1,True,39,0,39,2,1,pass
19878,1,True,24,23,47,2,2,pass
19879,1,True,203,0,203,4,2,pass
19880,1,True,7,2,9,1,1,pass
19885,1,True,3,3,6,1,1,pass
19892,1,True,8,4,12,2,2,pass
19893,1,True,141,0,141,2,2,pass
19894,1,True,1,0,1,1,1,pass
19895,1,True,1,0,1,1,1,fail
19896,1,True,2,0,2,1,1,fail
19897,1,True,76,131,207,20,2,fail
19898,1,True,107,1,108,2,2,pass
19900,1,True,30,9,39,3,2,pass
19901,1,True,0,0,0,2,1,pass
19902,1,True,262,0,262,6,2,pass
19904,1,True,262,0,262,7,2,pass
19905,1,True,133,27,160,4,2,pass
19906,1,True,107,1,108,2,1,pass
19907,1,True,2,390,392,5,2,pass
19908,1,True,4,2,6,1,1,pass
19910,1,True,329,62,391,6,1,pass
19911,1,True,107,1,108,2,1,pass
19912,1,True,31,31,62,1,1,pass
19913,1,True,128,2,130,3,2,pass
19914,1,True,106,0,106,1,1,pass
19915,1,True,3,3,6,2,1,pass
19916,1,True,1,1,2,1,1,pass
19917,1,True,33,17,50,4,3,pass
19918,1,True,130,0,130,2,2,pass
19919,1,True,21,6,27,7,3,pass
19920,1,True,70,0,70,3,1,pass
19921,1,True,122,4,126,3,3,pass
19923,1,True,2,2,4,1,1,pass
19924,1,True,17,0,17,1,1,fail
19925,1,True,107,1,108,2,1,pass
19926,1,True,2,1,3,1,1,pass
19927,1,True,2,2,4,1,1,fail
19928,1,True,1,3,4,1,1,fail
19929,1,True,2,0,2,1,1,fail
19930,1,True,16,3,19,2,2,fail
19931,1,True,107,1,108,2,2,pass
19932,1,True,0,0,0,2,1,pass
19933,1,True,2,1,3,1,1,pass
19935,1,True,3,3,6,1,1,pass
19936,1,True,23,5,28,1,1,fail
19943,1,True,3,3,6,3,2,pass
19945,1,True,1611,324,1935,3,1,pass
19946,1,True,134,0,134,2,2,pass
19947,1,True,77,49,126,1,1,pass
19949,1,True,2854,0,2854,9,2,pass
19951,1,True,11,13,24,1,1,pass
19952,1,True,106,2,108,2,2,pass
19953,1,True,5,0,5,2,2,pass
19954,1,True,114,5,119,2,2,pass
19955,2,True,1,1,2,1,1,pass
19956,2,True,169,21,190,8,4,fail
19957,1,True,128,0,128,2,2,pass
19958,1,True,4,2,6,1,1,pass
19959,1,True,112,6,118,2,2,pass
19960,1,True,28,10,38,3,2,pass
19962,1,True,1,1,2,1,1,pass
19963,1,True,112,2,114,3,1,pass
19964,1,True,5,0,5,1,1,pass
19965,1,True,1,1,2,1,1,pass
19966,1,True,0,88,88,3,2,pass
19967,1,True,1828,1793,3621,32,1,pass
19968,1,True,0,0,0,0,0,pass
19969,1,True,296,260,556,4,1,pass
19970,1,True,83,8,91,3,1,pass
19971,1,True,19,41,60,1,1,pass
19972,1,True,61,12,73,3,1,pass
19973,2,True,107,36,143,3,1,pass
19974,2,True,14,1,15,2,1,pass
19975,2,True,1798,174,1972,70,11,pass
19976,1,True,2,1,3,1,1,fail
19977,1,True,107,36,143,3,1,pass
19978,2,True,2,2,4,1,1,fail
19979,2,True,271,0,271,7,3,pass
19980,2,True,108,2,110,2,2,fail
19981,1,True,1,1,2,1,1,pass
19982,1,True,106,0,106,1,1,fail
19983,1,True,2,2,4,1,1,fail
19984,2,True,2,2,4,1,1,pass
19985,1,True,2,2,4,1,1,pass
19986,1,True,2,2,4,1,1,fail
19987,1,True,13,0,13,1,1,pass
19988,1,True,271,0,271,7,3,pass
19989,1,True,1,0,1,1,1,pass
19990,1,True,1,1,2,1,1,pass
19991,2,True,38,0,38,1,1,pass
19992,1,True,1,1,2,1,1,pass
19993,1,True,27,0,27,1,1,pass
19994,1,True,38,0,38,1,1,pass
19995,2,True,117,11,128,3,1,pass
19996,2,True,141,0,141,2,2,pass
19997,2,True,1,1,2,1,1,pass
19998,2,True,1,2,3,1,1,fail
19999,1,True,106,0,106,1,1,pass
20003,1,True,141,0,141,2,2,pass
20004,1,True,1,1,2,1,1,pass
20005,1,True,1,2,3,1,1,pass
20006,1,True,1,1,2,1,1,fail
20007,2,True,1,1,2,1,1,pass
20008,2,True,5,5,10,2,2,pass
20009,2,True,107,1,108,2,2,fail
20010,1,True,106,0,106,1,1,pass
20012,1,True,1,8,9,1,1,pass
20014,1,True,1,1,2,1,1,pass
20015,1,True,0,2,2,1,1,pass
20016,1,True,38,20,58,5,3,pass
20017,1,True,92,49,141,6,3,pass
20019,1,True,91,0,91,2,2,pass
20020,1,True,1,1,2,1,1,pass
20021,1,True,2,2,4,1,1,pass
20022,1,True,0,2,2,1,1,pass
20023,2,True,107,1,108,2,2,pass
20024,1,True,50,0,50,2,2,pass
20025,1,True,107,1,108,2,2,pass
20026,1,True,12,11,23,1,1,pass
20027,2,True,331,0,331,8,1,pass
20028,2,True,2,2,4,2,2,pass
20029,1,True,2,2,4,2,2,pass
20030,1,True,2,4,6,1,1,pass
20032,1,True,51,1,52,5,2,pass
20033,1,True,36,4,40,1,1,pass
20034,1,True,3,3,6,1,1,pass
20035,1,True,34,7,41,5,1,pass
20036,1,True,1,0,1,1,1,pass
20037,1,True,8,0,8,3,2,pass
20038,1,True,16,9,25,2,2,pass
20039,1,True,115,47,162,12,2,pass
20040,1,True,2,1,3,1,1,pass
20041,1,True,27,17,44,2,2,pass
20042,1,True,12,0,12,1,1,fail
20043,2,True,40,1,41,3,1,pass
20044,2,True,5,5,10,4,4,pass
20045,1,True,40,1,41,3,1,pass
20046,1,True,1,1,2,1,1,pass
20048,1,True,17,1,18,2,1,pass
20049,1,True,1,1,2,1,1,fail
20050,1,True,3,3,6,2,2,fail
20051,2,True,9,1,10,1,1,pass
20052,1,True,9,1,10,1,1,pass
20053,2,True,2,2,4,1,1,pass
20054,2,True,5,1,6,2,1,pass
20055,2,True,75,4,79,7,1,pass
20056,2,True,1,1,2,1,1,pass
20057,1,True,3,3,6,2,2,pass
20058,1,True,1,1,2,1,1,pass
20059,1,True,11,10,21,4,1,pass
20060,1,True,4,4,8,1,1,pass
20061,1,True,126,1,127,7,4,pass
20062,1,True,18,11,29,2,1,pass
20063,1,True,25,11,36,5,2,pass
20064,1,True,2,2,4,1,1,pass
20065,1,True,215,1,216,3,1,pass
20066,1,True,110,5,115,2,2,pass
20067,1,True,65,3,68,2,2,pass
20068,1,True,2,0,2,2,2,pass
20069,1,True,23,5,28,3,2,pass
20070,1,True,5,1,6,1,1,pass
20071,1,True,35,2,37,2,2,pass
20072,1,True,47,12,59,2,1,pass
20073,1,True,2,0,2,1,1,pass
20074,1,True,5,3,8,1,1,pass
20075,1,True,11,0,11,1,1,pass
20076,1,True,2,0,2,1,1,pass
20078,1,True,13,0,13,2,1,pass
20079,1,True,4,2,6,1,1,fail
20080,1,True,4,2,6,1,1,fail
20081,1,True,0,1,1,1,1,fail
20082,1,True,1,0,1,1,1,fail
20083,1,True,41,1,42,2,1,fail
20085,1,True,13,0,13,1,1,pass
20086,1,True,1,28,29,3,1,pass
20087,1,True,1,1,2,1,1,pass
20088,1,True,29,5,34,3,1,pass
20089,1,True,1,1,2,1,1,pass
20090,1,True,2,2,4,2,2,pass
20091,1,True,0,2,2,1,1,pass
20092,1,True,1897,33,1930,6,2,pass
20093,1,True,138,1,139,3,2,pass
20094,1,True,5,4,9,1,1,pass
20095,1,True,11,0,11,1,1,pass
20096,1,True,14,0,14,1,1,pass
20097,1,True,1,0,1,1,1,pass
20098,1,True,143,0,143,2,2,pass
20099,1,True,29,12,41,2,2,pass
20100,1,True,1,1,2,1,1,pass
20101,1,True,21,0,21,2,2,pass
20102,1,True,27,4,31,2,1,pass
20103,1,True,16,8,24,8,1,pass
20104,1,True,40,23,63,1,1,pass
20105,1,True,15,13,28,1,1,pass
20106,2,True,1,1,2,1,1,pass
20107,1,True,1,1,2,1,1,pass
20108,1,True,18,22,40,3,2,pass
20109,1,True,13,1,14,2,1,pass
20110,1,True,3,3,6,1,1,pass
20111,1,True,11,4,15,1,1,pass
20112,1,True,204,234,438,5,3,pass
20113,1,True,23,2,25,2,1,pass
20114,1,True,8,8,16,1,1,pass
20115,1,True,31,14,45,2,1,pass
20116,1,True,62,8,70,10,3,pass
20117,1,True,1,1,2,1,1,pass
20118,1,True,2,3,5,1,1,pass
20119,1,True,2,1,3,1,1,pass
20120,1,True,1,0,1,1,1,pass
20121,1,True,109,3,112,3,2,pass
20122,1,True,113,7,120,3,2,pass
20123,1,True,106,0,106,1,1,pass
20124,1,True,1,1,2,1,1,pass
20125,1,False,9,5,14,1,1,fail
20126,1,True,11,3,14,2,2,pass
20127,1,False,308,107,415,14,1,fail
20128,1,True,323,2,325,10,2,pass
20129,1,False,105,34,139,10,3,pass
20130,1,False,2,2,4,1,1,pass
20131,1,True,4,1,5,2,2,pass
20132,1,True,10,42,52,10,2,pass
20133,1,False,15,0,15,1,1,pass
20134,1,True,1,1,2,1,1,pass
20135,1,True,34,0,34,2,2,pass
20136,1,True,54,14,68,3,2,pass
20137,1,True,1,1,2,1,1,pass
20138,1,True,42,25,67,4,2,pass
20139,1,True,19,2,21,4,2,pass
20140,2,False,709,172,881,29,4,fail
20142,1,True,3,1,4,1,1,pass
20143,1,True,2,2,4,1,1,pass
20144,1,True,1,1,2,1,1,pass
20145,1,False,1,2,3,1,1,pass
20146,1,True,88,1,89,2,1,pass
20147,1,True,17,1,18,3,2,pass
20148,1,True,188,2,190,6,2,pass
20149,1,True,38,12,50,5,1,pass
20150,1,True,63,13,76,2,2,pass
20151,1,True,96,3,99,1,1,pass
20152,1,True,24,1,25,2,1,pass
20153,1,False,1,1,2,1,1,pass
20154,1,True,78,23,101,4,3,pass
20155,1,False,111,111,222,3,1,pass
20156,1,True,109,3,112,2,2,pass
20157,1,True,34,1,35,3,1,pass
20158,1,True,40,48,88,4,3,pass
20159,1,False,1,1,2,1,1,pass
20160,1,False,1,0,1,1,1,pass
20162,1,True,4,9,13,1,1,pass
20163,1,False,10,9,19,1,1,pass
20164,1,False,4,3,7,2,1,pass
20165,1,True,176,4,180,3,2,pass
20166,1,True,28,0,28,4,2,fail
20167,1,True,3,2,5,1,1,pass
20168,1,True,53,50,103,2,2,pass
20169,1,False,1,2,3,2,1,pass
20173,1,False,52,19,71,1,1,pass
20174,1,True,258,27,285,5,3,pass
20175,1,True,98,50,148,3,2,pass
20176,1,True,49,5,54,3,3,pass
20177,1,True,178,1,179,3,2,pass
20178,1,False,4,4,8,1,1,pass
20180,1,True,119,44,163,1,1,pass
20181,1,False,31,31,62,1,1,pass
20182,1,True,10,9,19,5,1,pass
20183,1,True,15,1,16,2,1,pass
20184,1,True,3,0,3,1,1,pass
20185,1,False,3,3,6,2,1,fail
20186,1,True,127,29,156,5,2,pass
20187,1,False,0,12,12,1,1,pass
20188,1,False,1,1,2,1,1,pass
20189,2,False,9,18,27,3,2,fail
20191,1,True,9,18,27,3,2,fail
20192,1,False,19,19,38,1,1,pass
20193,1,True,1,1,2,1,1,pass
20194,1,False,6,5,11,1,1,pass
20195,1,True,16,1,17,2,2,pass
20196,1,True,7,0,7,1,1,pass
20197,1,True,144,26,170,6,1,pass
20198,1,True,110,11,121,3,1,pass
20199,1,True,141,1,142,3,3,pass
20200,1,True,56,140,196,11,3,pass
20201,1,True,2,2,4,1,1,pass
20202,1,True,1,1,2,1,1,pass
20203,1,True,18,0,18,2,1,pass
20204,1,True,0,3,3,1,1,pass
20205,1,True,45,0,45,1,1,pass
20206,1,True,20,25,45,3,2,pass
20207,1,True,1,0,1,1,1,pass
20208,1,True,8,7,15,1,1,pass
20209,1,True,23,0,23,1,1,pass
20210,1,True,6,4,10,1,1,pass
20212,1,True,0,12,12,1,1,pass
20213,1,True,12,0,12,1,1,pass
20214,1,True,2,0,2,1,1,pass
20215,1,True,81,1,82,2,1,pass
20216,1,False,1,1,2,1,1,pass
20217,2,False,112,38,150,5,2,pass
20218,1,False,1,1,2,1,1,pass
20219,1,True,111,37,148,5,2,pass
20221,1,False,1,4,5,1,1,pass
20222,1,True,211,4,215,4,1,pass
20223,1,False,1,12,13,1,1,pass
20224,1,False,24,15,39,3,1,pass
20225,1,True,23,1,24,2,1,pass
20226,1,False,1,1,2,1,1,pass
20227,1,True,12,7,19,3,1,pass
20228,1,False,11,6,17,1,1,pass
20229,1,False,3,3,6,1,1,pass
20230,1,True,126,0,126,2,2,pass
20231,1,True,26,0,26,1,1,pass
20232,1,False,1,1,2,1,1,pass
20233,1,True,7,7,14,3,1,pass
20234,1,True,37,15,52,1,1,pass
20235,1,False,1,1,2,1,1,pass
20236,1,False,1,1,2,1,1,pass
20237,1,True,44,0,44,2,2,pass
20238,1,True,2,3,5,2,1,pass
20239,1,True,18,0,18,2,2,pass
20240,1,True,26,1,27,2,1,pass
20241,1,True,67,22,89,7,5,pass
20242,1,False,21,0,21,1,1,pass
20243,1,False,1,1,2,1,1,pass
20244,1,False,41,47,88,9,1,pass
20246,1,True,50,23,73,2,2,pass
20247,1,True,18,8,26,1,1,pass
20248,1,False,0,1,1,1,1,pass
20249,1,False,9,3,12,1,1,pass
20251,1,True,43,78,121,8,2,pass
20252,1,True,164,34,198,9,2,pass
20253,1,True,18,3,21,2,2,pass
20254,1,False,1,0,1,1,1,pass
20255,1,True,86,20,106,2,2,pass
20256,1,True,492,53,545,15,4,pass
20257,1,False,1,0,1,1,1,pass
20258,1,True,299,77,376,6,1,pass
20259,1,True,1,1,2,1,1,fail
20260,1,True,250,143,393,25,3,pass
20261,1,True,42,13,55,7,2,pass
20262,1,False,106,0,106,1,1,pass
20263,1,False,2,2,4,2,1,pass
20264,1,False,4,4,8,1,1,pass
20265,1,False,3,2,5,1,1,pass
20266,1,False,17,10,27,2,2,pass
20267,1,True,49,15,64,3,2,pass
20268,1,False,11,7,18,4,1,pass
20269,1,False,2,3,5,2,1,pass
20270,1,False,3,3,6,1,1,pass
20272,1,True,97,96,193,4,2,pass
20273,1,True,110,1,111,3,3,pass
20274,1,True,68,15,83,3,3,pass
20275,1,True,2,0,2,1,1,pass
20276,1,False,5,0,5,1,1,pass
20277,1,False,1,1,2,1,1,fail
20278,1,True,6,3,9,2,2,pass
20279,1,False,13,0,13,1,1,pass
20280,1,False,1,1,2,1,1,pass
20281,1,True,155,128,283,7,1,pass
20282,1,True,22,4,26,3,2,pass
20283,1,False,1,1,2,1,1,pass
20284,1,True,15,0,15,1,1,pass
20285,1,True,0,1,1,1,1,pass
20286,1,False,1,1,2,1,1,pass
20287,1,True,6,6,12,1,1,pass
20288,1,False,1,1,2,1,1,pass
20289,1,False,2,2,4,2,2,fail
20290,1,True,206,0,206,4,2,pass
20291,1,False,9,10,19,1,1,pass
20292,1,True,17,1,18,4,2,pass
20293,1,True,1,0,1,1,1,pass
20294,1,True,14,2,16,2,2,fail
20295,1,False,3,9,12,2,2,pass
20296,1,True,125,5,130,3,2,pass
20297,1,True,0,4,4,1,1,pass
20298,1,False,1,0,1,1,1,pass
20299,1,False,4,4,8,2,2,pass
20300,1,True,7,5,12,3,1,pass
20301,1,False,8,5,13,2,1,pass
20302,1,False,101,107,208,23,1,pass
20303,1,False,0,2,2,1,1,pass
20304,1,True,24,25,49,5,2,pass
20305,1,True,1,1,2,1,1,pass
20306,1,True,10,0,10,1,1,pass
20307,1,True,1,1,2,1,1,pass
20308,1,True,16,3,19,2,2,pass
20309,1,True,4,3,7,2,2,pass
20310,1,True,5,4,9,2,2,pass
20311,1,True,16,3,19,2,2,fail
20312,1,True,1163,811,1974,21,3,pass
20313,1,True,608,1,609,14,2,pass
20314,1,True,13,1,14,2,2,pass
20315,1,False,1,1,2,1,1,pass
20316,1,True,1,1,2,1,1,pass
20317,1,True,15,4,19,3,1,pass
20318,1,True,13,5,18,1,1,pass
20319,1,True,21,3,24,3,2,pass
20320,1,True,21,15,36,1,1,pass
20321,1,False,2,2,4,2,2,pass
20322,1,False,11,2,13,2,1,pass
20323,1,False,16,13,29,4,3,pass
20324,1,False,1,0,1,1,1,pass
20325,1,False,13,2,15,2,1,pass
20326,1,True,51,0,51,4,1,pass
20327,1,True,198,10,208,3,1,pass
20328,1,True,23,1,24,3,2,pass
20329,1,True,1,1,2,1,1,pass
20330,1,True,20,7,27,3,2,fail
20331,1,True,21,6,27,6,3,pass
20332,1,True,1,1,2,1,1,fail
20333,1,True,25,1,26,2,1,pass
20334,1,False,4,4,8,4,3,pass
20335,1,True,15,17,32,4,2,pass
20336,1,False,20,1,21,2,1,pass
20337,1,False,14,1,15,2,2,pass
20338,1,False,9,1,10,1,1,pass
20339,1,False,1,1,2,1,1,pass
20340,1,True,61,23,84,6,3,pass
20341,1,False,23,0,23,1,1,pass
20342,1,True,129,14,143,4,3,pass
20343,1,False,1,1,2,1,1,pass
20344,1,False,1,1,2,1,1,pass
20345,1,False,2,2,4,1,1,pass
20346,1,False,20,11,31,1,1,pass
20348,1,False,1,1,2,1,1,pass
20349,1,False,1,1,2,1,1,pass
20350,1,True,44,0,44,3,2,pass
20351,1,False,2,3,5,1,1,pass
20352,1,True,1,2,3,1,1,pass
20353,1,True,7,17,24,2,1,pass
20354,1,False,69,69,138,27,5,pass
20356,1,False,153,0,153,1,1,pass
20357,2,False,27,9,36,3,3,pass
20359,1,False,1,1,2,1,1,pass
20360,1,False,26,8,34,2,2,pass
20361,2,False,28,0,28,1,1,pass
20362,1,False,28,0,28,1,1,pass
20364,1,True,333,332,665,27,6,pass
20365,1,True,33,1,34,3,2,pass
20366,1,False,1,1,2,1,1,pass
20367,1,False,5,4,9,1,1,pass
20368,1,False,10,10,20,1,1,pass
20369,1,False,172,75,247,9,2,pass
20372,1,False,1,1,2,1,1,pass
20373,1,False,1,1,2,1,1,fail
20374,1,False,2,2,4,1,1,pass
20375,2,False,7,9,16,2,2,pass
20377,2,False,32,8664173,8664205,91,5,pass
20379,1,True,32,8664173,8664205,91,5,pass
20380,1,True,113,7,120,2,2,pass
20381,1,True,100,100,200,6,5,pass
20382,1,True,9,0,9,1,1,fail
20383,1,False,1,1,2,1,1,pass
20384,1,False,1,1,2,1,1,pass
20385,1,False,1,0,1,1,1,fail
20386,2,False,14,0,14,1,1,fail
20388,1,False,14,0,14,1,1,pass
20389,1,False,2,2,4,1,1,pass
20390,1,True,16,0,16,2,2,pass
20391,1,False,26,24,50,1,1,pass
20392,1,False,1,1,2,1,1,pass
20393,1,False,1,1,2,1,1,fail
20394,1,False,2,3,5,1,1,pass
20395,1,False,11,12,23,4,1,pass
20400,1,True,12,12,24,1,1,fail
20401,1,False,3,3,6,1,1,pass
20402,1,False,1,1,2,1,1,pass
20403,1,False,0,34,34,1,1,pass
20404,1,False,3,6,9,1,1,fail
20405,1,False,1,1,2,1,1,fail
20406,1,False,1,5,6,1,1,fail
20407,1,False,11,3,14,1,1,fail
20408,1,False,33,0,33,1,1,fail
20409,1,False,0,33,33,1,1,fail
20410,1,False,0,0,0,1,1,fail
20412,1,False,3,11,14,1,1,pass
20413,2,False,11,3,14,1,1,fail
20415,1,False,2,2,4,1,1,pass
20416,1,False,6,2,8,1,1,pass
20417,1,False,5,1,6,1,1,fail
20418,1,False,7,30,37,1,1,fail
20419,1,False,0,4,4,1,1,fail
20420,1,False,1,4,5,1,1,fail
20421,1,False,1,1,2,1,1,fail
20422,1,False,40,0,40,1,1,fail
20423,1,False,1,1,2,1,1,pass
20424,1,False,2,2,4,2,2,pass
20425,1,False,1,1,2,1,1,fail
20426,1,False,2,2,4,2,2,fail
20427,1,False,1,1,2,1,1,pass
20428,1,True,13,3,16,1,1,pass
20429,1,False,1,1,2,1,1,pass
20430,1,True,138,108,246,226,4,pass
20431,1,False,1,1,2,1,1,pass
20433,1,False,4,43,47,2,1,pass
20434,1,False,0,0,0,1,1,fail
20435,1,False,20,7,27,4,2,pass
20436,1,False,1,0,1,1,1,pass
20437,1,False,1,1,2,1,1,pass
20439,1,True,165,22,187,5,2,pass
20440,1,True,1,0,1,1,1,fail
20441,1,False,4,4,8,1,1,pass
20442,1,False,1,1,2,1,1,pass
20443,1,False,6,7,13,2,1,pass
20444,1,False,1,1,2,1,1,pass
20445,1,False,1,1,2,1,1,pass
20446,1,False,28,20,48,1,1,pass
20448,1,True,296,145,441,4,3,pass
20449,1,True,32,25,57,3,1,pass
20450,1,True,20,16,36,1,1,pass
20451,1,False,1,1,2,1,1,fail
20452,1,False,1,1,2,1,1,pass
20453,1,True,107,1,108,2,2,pass
20454,1,True,113,1,114,2,2,pass
20455,1,True,1,1,2,1,1,pass
20456,1,False,1,1,2,1,1,pass
20457,1,False,11,8,19,4,2,pass
20458,1,False,1,1,2,1,1,pass
20459,1,False,6,2,8,1,1,pass
20460,2,False,107,1,108,2,1,pass
20462,1,True,107,1,108,2,1,pass
20463,1,False,7,2,9,1,1,pass
20464,1,True,9,3,12,2,2,pass
20465,1,True,1,1,2,1,1,pass
20466,1,False,12,0,12,3,2,pass
20467,1,False,1,1,2,1,1,pass
20468,1,True,11,7,18,1,1,pass
20469,1,True,12,6,18,4,2,pass
20470,1,False,0,13,13,1,1,pass
20471,1,False,11,1,12,1,1,pass
20472,1,False,2,2,4,1,1,pass
20473,1,False,1,1,2,1,1,pass
20474,1,False,1,1,2,1,1,pass
20475,1,False,0,1,1,1,1,pass
20476,1,False,2,6,8,1,1,pass
20477,1,False,5,0,5,1,1,pass
20478,1,False,1,1,2,1,1,fail
20480,2,False,129,4,133,2,2,fail
20482,2,False,129,4,133,2,2,fail
20483,1,True,129,4,133,2,2,pass
20484,1,False,5,0,5,1,1,fail
20486,1,False,0,4,4,1,1,fail
20488,1,True,273,62,335,9,2,pass
20489,1,True,108,1,109,2,2,pass
20490,1,False,2,2,4,1,1,pass
20491,1,True,3,8,11,2,2,pass
20492,1,False,0,1,1,1,1,pass
20494,1,False,30,1,31,1,1,pass
20496,1,False,20,20,40,5,1,pass
20497,1,False,11,17,28,2,1,pass
20505,1,False,8,8,16,1,1,fail
20507,1,False,32,3,35,1,1,pass
20508,1,False,9,9,18,1,1,pass
20510,1,False,28,2,30,1,1,fail
20512,1,False,2,2,4,1,1,pass
20513,1,False,12,1,13,1,1,pass
20514,1,False,8,8,16,1,1,pass
20515,1,False,8,8,16,1,1,pass
20516,1,False,9,6,15,2,1,pass
20518,1,False,0,4,4,1,1,pass
20519,1,False,20,7,27,1,1,pass
20520,2,False,41,5,46,3,2,pass
20521,1,False,1,0,1,1,1,pass
20522,1,True,40,5,45,2,2,pass
20523,1,False,4,4,8,3,1,pass
20527,1,True,8253,94,8347,25,6,pass
20528,1,True,215,104,319,14,3,pass
20529,1,False,1,1,2,1,1,pass
20530,2,False,21,5,26,3,3,pass
20531,1,False,2,2,4,1,1,pass
20533,1,False,6,0,6,1,1,pass
20534,1,False,4,8,12,1,1,pass
20535,2,False,30,14,44,5,4,pass
20536,1,False,293,0,293,2,2,pass
20537,1,False,1,1,2,1,1,pass
20538,1,False,2,4,6,1,1,pass
20539,1,False,9,9,18,1,1,pass
20541,1,False,12,0,12,1,1,pass
20542,1,True,20,8,28,2,2,pass
20543,1,True,7,1,8,1,1,pass
20544,1,False,12,9,21,5,2,pass
20546,2,False,695,753,1448,11,2,pass
20547,1,True,690,752,1442,9,1,pass
20548,1,True,5,1,6,2,2,fail
20549,1,True,29,4,33,3,1,pass
20550,2,False,35,7,42,4,3,fail
20551,1,False,11,3,14,1,1,pass
20552,1,False,49,4,53,3,2,pass
20553,1,True,126,53,179,15,2,pass
20554,1,True,24,4,28,3,3,pass
20555,1,False,8,0,8,1,1,pass
20556,1,False,2,2,4,1,1,pass
20558,1,False,643,657,1300,44,3,pass
20559,2,False,1,1,2,1,1,pass
20560,1,False,1,1,2,1,1,pass
20561,1,False,18,18,36,1,1,pass
20562,1,False,71,70,141,1,1,pass
20563,1,False,252,75,327,3,2,pass
20566,1,False,50,81,131,1,1,pass
20568,1,False,2,0,2,1,1,pass
20572,1,False,93,21,114,2,2,pass
20573,2,False,183,3,186,7,3,pass
20574,1,True,847,65,912,23,4,pass
20575,1,False,1,0,1,1,1,pass
20576,1,True,28,0,28,2,1,pass
20577,1,True,135,1,136,3,3,pass
20578,1,True,18,1,19,2,2,pass
20579,1,False,1,1,2,1,1,pass
20580,1,False,2,0,2,1,1,pass
20581,1,False,1,1,2,1,1,pass
20582,1,False,3,3,6,1,1,pass
20583,1,False,90,97,187,10,1,pass
20584,1,False,1,1,2,1,1,pass
20585,1,False,1,1,2,1,1,pass
20586,2,False,1710,2132,3842,14,1,pass
20587,1,False,17,0,17,2,1,pass
20588,1,False,1693,2132,3825,12,1,pass
20589,2,False,2552,53,2605,25,5,pass
20591,1,False,20,20,40,1,1,pass
20592,1,False,2,2,4,2,2,fail
20593,1,True,1,1,2,1,1,fail
20594,1,True,9,3,12,2,1,fail
20595,1,True,236,22,258,8,3,pass
20596,1,True,38,10,48,8,1,pass
20597,1,True,2193,0,2193,3,2,pass
20599,1,True,63,5,68,3,3,pass
20600,1,False,1,1,2,1,1,pass
20604,1,True,253374,3,253377,6,3,pass
20605,1,True,1313650,0,1313650,5,3,pass
20606,1,True,130,110,240,2,2,pass
20607,1,True,6,6,12,1,1,pass
20608,1,True,10,9,19,1,1,pass
20609,1,True,7,1,8,2,1,pass
20610,1,False,5,1,6,1,1,pass
20611,2,True,2,2,4,1,1,pass
20612,2,True,22,0,22,1,1,pass
20613,1,True,22,0,22,1,1,pass
20614,1,True,2,2,4,1,1,pass
20615,1,False,1,1,2,1,1,pass
20616,1,False,1,0,1,1,1,pass
20617,2,True,4,1,5,1,1,pass
20618,1,True,4,1,5,1,1,pass
20619,1,False,1,0,1,1,1,pass
20620,1,False,18,24,42,3,1,pass
20621,1,False,73,30,103,8,1,pass
20622,1,False,0,0,0,1,1,pass
20623,1,False,0,30,30,2,1,pass
20624,2,True,9,14,23,2,2,fail
20625,1,True,2,7,9,1,1,fail
20627,2,True,64,2,66,2,2,pass
20628,1,False,8,2,10,1,1,fail
20630,1,False,4,8,12,1,1,pass
20631,1,False,5,5,10,1,1,pass
20634,1,True,1880,22,1902,14,4,pass
20635,1,True,58,1,59,2,1,pass
20636,2,True,3,1,4,1,1,pass
20637,1,True,3,1,4,1,1,pass
20638,1,False,1,1,2,1,1,pass
20640,1,False,3,2,5,1,1,pass
20641,2,True,140,9,149,8,4,fail
20642,1,True,7,2,9,1,1,pass
20644,1,False,24,1,25,1,1,pass
20645,1,True,49,7,56,1,1,fail
20646,1,False,15,0,15,1,1,pass
20647,1,True,4,0,4,1,1,pass
20650,1,True,2,2,4,1,1,pass
20651,1,True,2,2,4,1,1,pass
20652,1,True,1,0,1,1,1,pass
20653,1,True,2,0,2,1,1,pass
20654,1,False,1,1,2,1,1,fail
20655,1,False,1,1,2,1,1,fail
20659,2,False,29,11,40,5,4,fail
20660,1,True,30,1,31,1,1,pass
20661,1,False,12,0,12,1,1,pass
20662,1,False,11,5,16,1,1,pass
20664,2,False,1396540,1721953,3118493,276,11,fail
20665,1,False,3,3,6,2,2,fail
20667,1,True,1,0,1,1,1,pass
20668,1,True,6,6,12,1,1,pass
20669,1,True,51,9,60,5,2,pass
20670,1,True,39,10,49,4,3,pass
20671,1,False,0,1,1,1,1,pass
20672,1,True,1341979,1788651,3130630,142,5,pass
20673,1,True,2,1,3,1,1,pass
20674,1,False,37,37,74,4,1,pass
20675,1,True,368,3,371,9,1,pass
20676,1,True,19,5,24,3,3,pass
20677,1,True,61,1,62,3,2,pass
20678,1,True,2,4,6,3,2,pass
20679,1,False,57,0,57,2,2,pass
20680,1,True,51,6,57,4,3,pass
20681,1,True,5,5,10,4,2,pass
20682,2,False,521963,2299,524262,300,10,fail
20683,1,True,162,58,220,15,3,pass
20684,1,False,48,0,48,1,1,pass
20685,1,False,83207,82197,165404,69,1,pass
20686,1,False,5,10,15,1,1,pass
20687,1,True,21,0,21,1,1,pass
20688,1,False,27,0,27,1,1,pass
20689,1,False,55,45,100,1,1,fail
20690,1,False,21,0,21,3,1,pass
20691,2,False,1519384,1401653,2921037,59,4,pass
20695,1,False,2,2,4,1,1,pass
20696,1,True,136,1,137,2,2,pass
20697,1,False,1,1,2,1,1,pass
20698,1,True,1,1,2,1,1,pass
20699,1,False,2,0,2,2,1,pass
20700,1,False,41,17,58,1,1,pass
20701,1,False,1,0,1,1,1,pass
20702,1,True,9,6,15,1,1,pass
20703,1,True,124,0,124,2,2,pass
20704,1,False,44,34,78,6,2,pass
20705,1,True,1,1,2,1,1,pass
20706,1,False,126,104,230,12,1,pass
20707,1,False,2,2,4,1,1,pass
20709,1,True,118,4,122,2,2,pass
20710,1,True,30,0,30,1,1,pass
20711,1,False,3,3,6,1,1,pass
20712,1,True,194,33,227,2,2,pass
20713,1,True,127,1,128,3,3,pass
20714,1,True,3,2,5,2,2,pass
20715,1,True,123,2,125,3,2,pass
20716,1,True,4,1,5,1,1,pass
20717,1,True,1111,759,1870,18,2,pass
20718,1,False,0,6,6,1,1,pass
20719,1,False,0,0,0,1,1,pass
20720,1,False,6,0,6,1,1,pass
20721,1,True,270,7,277,5,2,pass
20722,1,False,19,5,24,1,1,pass
20723,1,False,2,1,3,1,1,pass
20724,1,True,122,0,122,2,2,pass
20725,1,True,54,0,54,2,2,pass
20726,1,False,1,1,2,1,1,pass
20727,1,False,1,1,2,1,1,fail
20728,1,False,1,1,2,1,1,pass
20731,1,True,11,0,11,1,1,pass
20732,1,False,5,7,12,1,1,pass
20733,1,True,61,4,65,4,2,pass
20734,1,False,3,3,6,1,1,pass
20735,1,False,32,2,34,1,1,pass
20736,1,False,15,14,29,1,1,pass
20737,1,True,117,0,117,4,2,pass
20738,1,True,4,1,5,2,2,pass
20739,1,True,9,2,11,1,1,pass
20740,1,False,26,2,28,1,1,pass
20741,1,True,533,2,535,4,2,pass
20742,1,True,1,1,2,1,1,pass
20743,1,True,58,3,61,2,2,pass
20744,1,False,1,1,2,1,1,pass
20745,1,True,5,10,15,4,1,pass
20746,1,True,107,1,108,2,2,pass
20747,1,False,23,21,44,3,1,pass
20748,1,False,7,5,12,1,1,pass
20749,1,False,17,0,17,2,1,pass
20750,1,False,2,2,4,1,1,pass
20751,1,False,1,1,2,1,1,pass
20753,1,True,28,17,45,1,1,pass
20754,1,True,88,45,133,3,1,pass
20755,1,True,71,11,82,3,1,pass
20756,1,True,2,2,4,1,1,pass
20757,1,True,1,1,2,1,1,pass
20758,1,True,107,1,108,2,2,pass
20759,1,True,65,1,66,2,2,pass
20760,1,False,1,1,2,1,1,pass
20761,1,False,2,2,4,1,1,pass
20762,1,False,12,5,17,1,1,pass
20764,1,True,67,8,75,3,2,pass
20765,1,False,1,1,2,1,1,pass
20766,1,False,1,1,2,1,1,pass
20767,1,False,1,1,2,1,1,pass
20768,1,False,2,0,2,1,1,pass
20769,1,True,4,1,5,1,1,pass
20770,1,False,88,116,204,1,1,pass
20771,1,True,117,7,124,3,2,pass
20772,1,False,77,0,77,1,1,pass
20776,1,True,2,1,3,1,1,pass
20777,1,True,31,9,40,3,2,pass
20778,2,True,706,372,1078,16,3,pass
20779,1,True,0,4,4,1,1,pass
20780,1,True,157,5,162,3,2,pass
20781,1,True,1,1,2,1,1,pass
20782,1,True,55,36,91,3,1,fail
20783,1,True,18,6,24,2,2,pass
20784,1,True,12,10,22,2,1,fail
20785,1,True,2,2,4,1,1,pass
20786,1,True,2,12,14,1,1,pass
20787,1,True,3,1,4,2,2,pass
20788,1,True,12,11,23,2,2,fail
20789,1,False,28,0,28,1,1,pass
20790,2,True,473,55,528,19,3,pass
20793,2,True,6,8,14,1,1,pass
20794,1,True,6,8,14,1,1,fail
20795,1,True,1,1,2,1,1,pass
20799,1,False,2,2,4,1,1,pass
20801,2,True,5,3,8,2,2,pass
20802,1,True,2,2,4,1,1,pass
20807,1,True,142,6,148,3,2,pass
20809,1,False,9,0,9,1,1,pass
20810,1,False,4,3,7,1,1,pass
20811,2,True,135,8,143,3,2,pass
20812,1,True,9,0,9,1,1,pass
20814,1,True,10,0,10,1,1,fail
20816,1,True,47,0,47,1,1,pass
20819,1,True,17,0,17,1,1,pass
20820,1,False,1,1,2,1,1,pass
20823,1,False,22,0,22,1,1,pass
20824,1,False,18,0,18,1,1,pass
20825,2,True,108,2,110,2,1,pass
20831,1,True,106,0,106,1,1,pass
20832,2,True,104,16,120,11,5,pass
20834,2,True,34,1,35,3,1,pass
20835,1,False,3,1,4,1,1,fail
20836,1,False,2,1,3,1,1,fail
20837,1,False,1,1,2,1,1,pass
20838,1,True,34,1,35,3,1,pass
20839,1,False,9,8,17,1,1,pass
20840,1,False,2,2,4,1,1,pass
20841,1,True,51,0,51,1,1,pass
20842,1,False,3,3,6,3,3,pass
20843,1,False,3,3,6,3,3,pass
20844,1,False,8,5,13,1,1,pass
20846,2,True,36,7,43,4,3,pass
20847,2,True,119,1,120,3,2,pass
20848,1,True,2,9,11,3,3,pass
20850,1,True,4,5,9,2,2,pass
20851,1,False,8,1,9,1,1,pass
20852,2,True,118,81,199,8,1,pass
20853,1,False,2,4,6,1,1,pass
20854,1,False,118,79,197,8,1,fail
20855,2,True,3,3,6,1,1,fail
20857,2,True,3,3,6,1,1,fail
20858,1,False,1,1,2,1,1,pass
20860,1,True,3,1,4,1,1,fail
20864,2,False,9,1,10,3,3,fail
20866,1,True,9,1,10,3,3,fail
20867,1,False,45,28,73,1,1,pass
20868,1,False,4,0,4,1,1,pass
20869,1,False,0,1,1,1,1,pass
20870,1,False,23,0,23,1,1,pass
20871,1,False,1,1,2,1,1,pass
20872,1,False,344,433,777,19,1,pass
20873,1,False,32,23,55,2,2,pass
20874,1,False,6,6,12,2,1,fail
20877,2,True,2418,242,2660,29,3,pass
20878,1,False,6,2,8,1,1,pass
20880,1,False,27,1,28,3,1,pass
20881,1,False,7,7,14,1,1,pass
20882,1,True,11,4,15,3,2,pass
20883,1,True,452,0,452,12,4,pass
20884,2,True,245809,523,246332,36,5,pass
20885,1,False,1,1,2,1,1,fail
20886,1,True,36,6,42,2,2,fail
20887,1,True,28,0,28,1,1,pass
20888,1,True,46,4,50,4,2,pass
20889,1,True,106,0,106,1,1,fail
20891,1,True,121,0,121,3,2,pass
20892,1,True,106,1,107,2,2,pass
20893,1,True,245058,483,245541,13,2,pass
20894,1,True,22,29,51,1,1,pass
20895,1,True,0,2,2,1,1,pass
20896,1,True,12,9,21,2,2,pass
20897,1,True,23,21,44,2,2,pass
20898,1,True,4,5,9,2,1,pass
20899,1,True,41,16,57,3,2,pass
20900,1,True,41,25,66,3,2,pass
20901,1,True,7,3,10,3,1,pass
20902,1,True,76,61,137,6,2,fail
20903,1,False,31,3,34,3,2,pass
20904,1,True,16,18,34,4,3,pass
20905,1,False,1,1,2,1,1,pass
20906,1,False,3,3,6,1,1,pass
20907,1,False,16,1,17,2,1,pass
20908,1,True,42,30,72,2,2,pass
20909,1,True,69,43,112,2,1,pass
20910,1,True,56,3,59,8,3,fail
20911,1,True,3,18,21,1,1,pass
20912,1,True,45,44,89,2,1,pass
20913,1,True,5,5,10,1,1,pass
20914,2,True,231,14,245,7,2,pass
20916,1,False,1,0,1,1,1,pass
20917,1,False,25,5,30,1,1,pass
20918,1,True,1,1,2,1,1,pass
20920,1,True,107,1,108,2,1,pass
20921,1,True,16,11,27,3,2,pass
20922,1,True,108,2,110,2,1,fail
20923,1,True,16,16,32,1,1,pass
20924,1,True,1,2,3,1,1,fail
20925,1,True,14,17,31,4,2,fail
20933,1,False,5,5,10,1,1,pass
20934,1,True,110,1,111,2,1,pass
20935,1,True,190,6,196,3,2,pass
20936,1,True,75,89,164,3,2,pass
20937,1,True,13,38,51,1,1,pass
20938,1,True,77,5,82,4,2,pass
20941,1,True,2,2,4,1,1,pass
20945,1,False,23,0,23,1,1,pass
20948,1,True,16,0,16,2,2,pass
20951,1,True,3,3,6,1,1,pass
20952,1,True,106,0,106,1,1,pass
20954,2,False,1421,97,1518,38,5,pass
20964,1,False,3,3,6,1,1,pass
20965,1,True,1,1,2,1,1,pass
20967,1,True,106,0,106,1,1,pass
20968,1,True,1,1,2,1,1,pass
20969,1,False,16,0,16,1,1,pass
20972,1,False,36,0,36,1,1,pass
20973,1,False,43,10,53,1,1,pass
20974,1,False,9,14,23,1,1,pass
20975,1,True,91,7,98,1,1,pass
20976,1,True,182,0,182,4,2,pass
20977,1,True,17,0,17,1,1,pass
20978,1,True,106,0,106,1,1,pass
20979,1,False,3,4,7,1,1,pass
20980,1,False,8,2,10,1,1,pass
20981,1,False,2,2,4,1,1,pass
20982,1,True,107,1,108,2,1,pass
20983,1,True,4,4,8,3,2,pass
20984,1,True,15,5,20,5,3,pass
20986,1,True,1,1,2,1,1,pass
20988,1,False,1,1,2,1,1,pass
20991,1,True,7,1,8,1,1,pass
20994,1,True,322,0,322,3,2,pass
20995,1,False,32,0,32,2,2,pass
21007,1,True,175,49,224,2,2,pass
21011,1,False,1,2,3,2,1,pass
21016,1,True,11,2,13,3,1,pass
21021,1,False,1,1,2,1,1,pass
21022,1,False,1,1,2,1,1,pass
21024,1,False,15,10,25,1,1,fail
21025,1,False,1,1,2,1,1,pass
21027,1,False,0,1,1,1,1,pass
21028,1,False,16,0,16,1,1,pass
21029,1,False,1,1,2,1,1,pass
21030,1,False,6,3,9,1,1,pass
21031,1,True,3,2,5,2,2,pass
21032,1,False,4,4,8,1,1,pass
21033,1,False,3,3,6,3,1,pass
21035,1,True,18,0,18,1,1,pass
21036,1,True,1,1,2,1,1,pass
21037,1,True,106,0,106,1,1,pass
21038,1,False,1,1,2,1,1,pass
21042,1,True,127,0,127,2,2,pass
21043,1,True,62,0,62,3,2,pass
21045,1,True,107,1,108,2,2,pass
21046,1,True,96,1,97,2,2,pass
21047,1,False,1,2,3,2,1,pass
21049,1,False,2,2,4,1,1,pass
21051,1,False,19,3,22,1,1,pass
21053,1,True,3,2,5,1,1,pass
21057,1,False,5,5,10,1,1,pass
21058,1,False,2,2,4,2,2,pass
21059,1,True,14,0,14,1,1,pass
21065,1,True,64,0,64,2,1,pass
21066,1,True,107,1,108,2,1,pass
21067,1,True,7,7,14,2,1,pass
21071,1,True,1,1,2,1,1,pass
21072,1,True,107,1,108,2,1,pass
21073,1,True,106,0,106,1,1,pass
21076,1,True,2,12,14,2,1,pass
21077,1,True,2,2,4,1,1,pass
21078,2,False,128,0,128,2,2,pass
21085,1,False,1,0,1,1,1,pass
21088,1,True,31,3,34,1,1,pass
21089,1,False,2,1,3,1,1,pass
21094,1,False,14,13,27,2,2,fail
21095,1,True,29,16,45,2,2,pass
21096,1,True,93,3,96,2,1,pass
21097,1,False,1,1,2,1,1,pass
21106,1,True,106,0,106,1,1,pass
21107,1,True,1,1,2,1,1,pass
21108,1,True,106,0,106,1,1,pass
21109,1,False,2,2,4,1,1,pass
21110,2,False,142,6,148,3,2,pass
21112,1,True,142,6,148,3,2,pass
21113,1,True,36,1,37,2,1,pass
21116,1,False,1,1,2,1,1,pass
21117,1,False,0,45,45,2,2,pass
21118,1,True,109,3,112,2,2,pass
21121,1,True,1,0,1,1,1,pass
21122,1,True,106,0,106,1,1,pass
21123,1,True,106,0,106,1,1,pass
21124,1,True,35,0,35,1,1,pass
21127,1,True,107,1,108,2,1,pass
21128,1,False,16,1,17,2,2,pass
21129,2,False,1,1,2,1,1,pass
21131,1,True,1,1,2,1,1,pass
21133,1,False,1,1,2,1,1,pass
21135,1,True,0,1,1,1,1,pass
21136,1,True,129,0,129,5,4,pass
21137,1,True,71,60,131,1,1,pass
21138,1,True,128,21,149,2,2,pass
21139,2,True,85,26,111,1,1,pass
21140,2,True,1,6,7,1,1,pass
21145,2,True,53,3,56,3,1,pass
21146,1,True,261835,47,261882,28,2,pass
21147,1,True,14,7,21,3,1,pass
21148,1,False,40,5,45,2,1,pass
21149,1,False,1,7,8,1,1,pass
21150,1,True,528,0,528,2,2,pass
21151,1,True,115,9,124,2,1,pass
21152,1,True,2,0,2,2,1,pass
21153,1,True,5,5,10,2,1,fail
21154,1,True,9,10,19,2,1,fail
21157,1,False,1,1,2,1,1,pass
21158,1,True,36,0,36,2,1,pass
21159,1,False,43,39,82,8,1,pass
21161,1,True,2,0,2,1,1,pass
21164,1,True,3,2,5,1,1,pass
21165,1,True,1,0,1,1,1,fail
21166,1,True,7,3,10,1,1,fail
21167,1,True,0,0,0,1,1,pass
21168,1,True,31,0,31,1,1,fail
21169,2,False,1127,61,1188,37,9,pass
21170,1,False,3,3,6,1,1,pass
21171,2,False,728,48,776,21,7,pass
21172,1,False,46,31,77,4,3,pass
21173,2,True,571,12,583,15,3,pass
21174,1,True,111,5,116,2,2,pass
21175,2,False,2,0,2,1,1,pass
21176,1,False,2,0,2,1,1,pass
21177,2,False,137,0,137,2,2,pass
21178,1,True,137,0,137,2,2,pass
21179,2,False,147,11,158,8,3,pass
21183,1,False,2,1,3,1,1,pass
21185,2,True,663,281,944,33,8,pass
21187,1,False,1,0,1,1,1,pass
21188,1,True,111,1,112,2,2,pass
21189,2,False,508,257,765,24,6,pass
21190,1,False,0,0,0,1,1,pass
21191,1,False,1,1,2,1,1,pass
21192,1,False,1,1,2,1,1,pass
21193,1,False,1,1,2,1,1,pass
21194,1,False,17,0,17,3,2,pass
21195,1,False,5,5,10,1,1,pass
21196,1,True,68,44,112,4,3,pass
21197,1,False,2,0,2,1,1,pass
21199,1,True,386,182,568,17,5,pass
21200,1,True,6,20,26,2,2,pass
21201,1,False,26,12,38,1,1,pass
21202,1,False,1,1,2,1,1,pass
21203,1,False,2,2,4,1,1,pass
21204,1,False,23,0,23,1,1,pass
21205,2,False,12,15,27,1,1,pass
21206,1,False,12,15,27,1,1,pass
21207,2,False,2,2,4,1,1,pass
21208,1,False,2,2,4,1,1,pass
21209,2,False,1,1,2,1,1,pass
21210,1,False,1,1,2,1,1,pass
21211,2,False,5,3,8,2,2,pass
21212,1,False,2,2,4,1,1,pass
21213,1,True,15,10,25,2,2,pass
21214,1,True,4,0,4,2,1,pass
21215,1,True,22,22,44,1,1,pass
21216,1,False,3,1,4,1,1,pass
21217,2,False,276,18,294,9,4,pass
21218,1,True,1,1,2,1,1,pass
21219,1,False,9,5,14,2,1,pass
21220,1,True,25,25,50,1,1,pass
21221,1,True,4,4,8,3,2,fail
21222,2,True,30,3,33,4,2,fail
21223,1,False,1,1,2,1,1,pass
21224,2,True,3,3,6,3,2,fail
21225,1,True,29,2,31,3,2,pass
21226,1,False,2,2,4,2,2,pass
21227,1,False,1,1,2,1,1,pass
21228,1,False,2,3,5,1,1,pass
21229,1,True,0,0,0,1,1,fail
21260,1,False,66,5,71,1,1,fail
21261,1,False,10,0,10,1,1,fail
21263,2,True,174,14,188,2,1,pass
21268,1,True,5,5,10,1,1,pass
21269,1,True,174,14,188,2,1,fail
21274,1,False,6,1,7,1,1,pass
21275,1,False,1,1,2,1,1,pass
21276,2,False,5,1,6,1,1,pass
21279,1,False,5,1,6,1,1,pass
21280,2,False,189,60,249,18,3,pass
21281,1,False,8,8,16,1,1,pass
21282,2,True,116,1,117,3,2,pass
21283,2,True,22,26,48,7,1,pass
21284,1,True,11,10,21,3,1,pass
21286,1,True,5,4,9,2,1,pass
21287,1,True,1,4,5,1,1,pass
21288,1,True,117,10,127,4,2,fail
21289,1,True,21,22,43,6,1,pass
21290,1,False,3,4,7,1,1,pass
21291,2,False,4,3,7,1,1,pass
21294,1,False,4,3,7,1,1,pass
21299,1,True,4,4,8,1,1,pass
21305,1,False,1,1,2,1,1,pass
21306,1,False,0,0,0,1,1,pass
21307,1,False,1,0,1,1,1,pass
21308,1,False,2,2,4,1,1,pass
21309,1,True,1,1,2,1,1,pass
21310,1,False,23,0,23,1,1,pass
21311,1,False,1,2,3,1,1,pass
21312,1,False,1,1,2,1,1,pass
21316,1,False,12,6,18,3,2,pass
21317,1,True,20,20,40,6,3,pass
21320,1,False,1,1,2,1,1,pass
21321,1,True,61,12,73,2,2,pass
21322,1,False,2,2,4,1,1,pass
21323,1,False,4,2,6,1,1,pass
21324,1,False,29,30,59,3,1,pass
21325,1,False,1,1,2,1,1,pass
21326,1,True,4,4,8,1,1,pass
21327,1,True,31,5,36,2,2,pass
21328,2,True,106,67,173,6,3,pass
21329,1,False,22,1,23,2,2,pass
21330,1,True,2,2,4,1,1,pass
21331,1,True,12,8,20,1,1,pass
21332,1,True,10,6,16,1,1,fail
21334,1,True,11,1,12,1,1,pass
21335,1,False,1,1,2,1,1,pass
21336,1,False,48,20,68,13,1,pass
21337,1,False,1,1,2,1,1,pass
21339,1,False,2,2,4,2,1,pass
21340,2,False,2650,2232,4882,115,10,pass
21341,1,False,9,11,20,1,1,pass
21342,1,False,1,1,2,1,1,pass
21344,2,True,96685,73047,169732,300,13,pass
21345,2,True,15,4,19,7,3,pass
21346,1,True,165,123,288,7,2,pass
21347,1,True,34,1,35,6,2,pass
21357,1,True,8,1,9,3,2,pass
21362,1,True,11,5,16,3,2,pass
21363,1,True,23,22,45,9,2,pass
21364,1,True,1,1,2,1,1,pass
21365,1,True,20,1,21,2,2,pass
21366,1,True,5,2,7,1,1,pass
21369,1,True,1,1,2,1,1,pass
21370,1,True,1,1,2,1,1,pass
21372,2,True,57,35,92,15,3,pass
21373,1,True,31,20,51,11,2,pass
21374,1,True,16,3,19,1,1,pass
21376,2,True,1133,1479,2612,48,7,pass
21377,2,True,1,1,2,1,1,pass
21379,1,True,1,1,2,1,1,fail
21382,2,True,175,20,195,5,3,pass
21384,1,True,4,5,9,1,1,pass
21385,1,True,109,2,111,2,2,pass
21386,1,True,8,8,16,2,1,pass
21388,1,True,49,0,49,1,1,pass
21389,1,True,2,1,3,1,1,pass
21391,1,True,15,14,29,1,1,pass
21392,1,True,86,21,107,4,1,pass
21393,2,True,0,0,0,0,0,pass
21394,1,True,7,7,14,5,2,pass
21396,2,True,620,567,1187,18,3,pass
21397,1,True,496,497,993,7,1,pass
21399,1,True,68,64,132,2,1,pass
21401,1,True,24,5,29,2,1,pass
21403,2,True,180,25,205,10,3,pass
21404,1,True,1,0,1,1,1,pass
21405,1,True,19,1,20,3,3,pass
21406,1,True,8,0,8,1,1,pass
21408,2,True,152,23,175,4,2,pass
21409,1,True,46,23,69,3,2,pass
21410,1,True,106,0,106,1,1,pass
21412,2,True,121,55,176,8,3,pass
21413,1,True,31,8,39,3,2,pass
21414,2,True,7,5,12,1,1,pass
21416,1,True,7,5,12,1,1,pass
21417,1,True,7,7,14,1,1,fail
21418,1,True,75,35,110,2,2,pass
21419,1,True,1,1,2,1,1,pass
21420,1,True,107,1,108,2,2,pass
21421,1,True,1,0,1,1,1,pass
21422,2,True,2759,1534,4293,71,6,pass
21423,1,True,598,314,912,25,3,pass
21424,1,True,13,0,13,1,1,pass
21425,1,True,0,5,5,2,1,pass
21426,1,True,5,2,7,2,2,pass
21427,1,True,3,1,4,1,1,pass
21429,1,True,1,1,2,1,1,fail
21430,1,True,0,1,1,1,1,fail
21432,1,True,53,28,81,3,3,pass
21433,1,True,12,0,12,1,1,pass
21435,1,True,94,32,126,5,3,pass
21436,1,True,26,18,44,1,1,fail
21437,1,True,27,0,27,1,1,fail
21439,2,False,209,99,308,12,5,pass
21440,1,False,1,7,8,1,1,pass
21441,1,False,58,41,99,4,2,pass
21442,1,False,58,67,125,4,2,pass
21443,1,True,2,0,2,1,1,pass
21445,1,True,1,1,2,1,1,pass
21446,1,True,1,0,1,1,1,pass
21447,1,True,13,62,75,5,3,pass
21448,1,True,5,0,5,1,1,fail
21450,1,False,2,0,2,1,1,fail
21455,1,True,1,1,2,1,1,fail
21457,1,True,22,0,22,1,1,fail
21458,1,True,1,1,2,1,1,fail
21460,1,False,5,0,5,1,1,pass
21461,1,False,10,5,15,1,1,fail
21463,1,True,1,1,2,1,1,fail
21464,1,True,1,1,2,1,1,fail
21466,1,True,4,4,8,1,1,fail
21467,1,True,4,4,8,1,1,fail
21468,1,False,1,1,2,1,1,fail
21469,1,True,1,1,2,1,1,fail
21470,1,True,1,1,2,1,1,fail
21471,2,True,75,0,75,1,1,fail
21472,1,False,3,7,10,1,1,fail
21473,2,False,2,10,12,2,2,pass
21475,1,False,2,0,2,1,1,fail
21477,1,False,1,3,4,2,2,fail
21478,1,False,21,2,23,3,3,fail
21481,1,False,1,1,2,1,1,pass
21482,1,False,1,1,2,1,1,fail
21483,1,False,1,1,2,1,1,fail
21484,1,False,2,2,4,1,1,fail
21485,1,False,2,2,4,1,1,fail
21487,1,False,3,3,6,1,1,fail
21488,1,False,71,0,71,1,1,fail
21489,1,True,61,26,87,4,3,pass
21490,1,False,2,10,12,2,2,pass
21491,1,False,2,2,4,1,1,fail
21492,1,False,1,1,2,1,1,fail
21493,1,False,2,1,3,1,1,fail
21495,1,False,1,0,1,1,1,fail
21496,1,False,1,1,2,1,1,fail
21497,1,False,17,7,24,3,2,fail
21498,1,False,2,1,3,1,1,fail
21499,2,False,61,57,118,5,1,fail
21501,1,False,60,57,117,4,1,fail
21503,1,True,1591,1039,2630,39,3,pass
21504,1,False,5,0,5,1,1,pass
21511,2,True,111,2,113,2,2,pass
21512,1,False,42,42,84,1,1,pass
21518,1,True,112,1,113,2,2,pass
21519,1,False,0,4,4,1,1,fail
21524,1,False,9,0,9,1,1,fail
21525,1,False,490,1026,1516,7,3,fail
21528,1,False,10,13,23,2,2,pass
21532,1,True,2,2,4,1,1,pass
21533,2,True,124,12,136,6,2,pass
21534,1,True,2,2,4,1,1,pass
21535,1,False,3,0,3,1,1,fail
21544,1,False,24,92,116,1,1,fail
21545,1,False,3,2,5,1,1,fail
21546,1,True,4,9,13,4,1,pass
21549,2,False,1600856,427664,2028520,300,14,fail
21550,1,True,126,8,134,5,2,pass
21552,2,True,16,22,38,2,2,pass
21553,1,True,14,11,25,1,1,pass
21554,1,True,2,0,2,1,1,fail
21556,2,True,332,115,447,5,3,pass
21557,1,True,332,115,447,5,3,pass
21558,2,True,144,48,192,18,4,pass
21559,1,True,43,13,56,1,1,pass
21560,1,True,1,1,2,1,1,pass
21562,1,True,0,1,1,1,1,fail
21564,1,True,2,2,4,1,1,pass
21565,1,True,1,1,2,1,1,pass
21566,1,True,9,9,18,1,1,pass
21567,1,True,17,7,24,4,3,fail
21568,1,True,3,0,3,1,1,pass
21569,1,True,1,1,2,2,1,pass
21570,1,True,19,4,23,5,3,pass
21571,1,True,18,4,22,3,3,fail
21572,1,True,15,1,16,1,1,pass
21574,1,True,1,1,2,1,1,pass
21575,1,True,18,3,21,4,2,pass
21576,1,True,576,3770,4346,11,3,pass
21577,1,True,52,32,84,4,2,pass
21579,1,True,1,18,19,3,2,pass
21581,1,True,1,1,2,2,1,pass
21582,1,True,7,0,7,3,2,pass
21583,1,True,25,8,33,1,1,pass
21584,1,True,9,2,11,3,2,pass
21585,1,True,453,3708,4161,2,1,pass
21586,1,True,1,1,2,1,1,pass
21587,1,True,21,0,21,1,1,pass
21588,2,True,6,3,9,3,2,fail
21590,1,True,6,3,9,3,2,pass
21591,1,True,1,1,2,1,1,pass
21592,1,True,2,2,4,1,1,pass
21593,1,True,2,0,2,1,1,pass
21594,2,True,272,50,322,12,4,fail
21596,2,True,1,0,1,1,1,pass
21597,1,True,1,0,1,1,1,pass
21598,2,True,6,4,10,2,1,pass
21599,1,True,6,4,10,2,1,pass
21600,2,True,603,93,696,17,5,pass
21601,1,True,265,46,311,10,4,pass
21602,1,True,2,2,4,1,1,pass
21603,1,True,1,1,2,1,1,pass
21605,1,True,348,43,391,5,1,pass
21606,1,True,21,0,21,1,1,pass
21607,2,True,29,6,35,4,3,pass
21608,1,True,27,0,27,1,1,fail
21610,1,True,2,0,2,1,1,pass
21611,1,True,0,5,5,1,1,pass
21612,2,True,63,56,119,5,1,pass
21613,1,True,63,56,119,5,1,fail
21614,2,True,1,1,2,1,1,pass
21615,1,True,1,1,2,1,1,pass
21616,2,True,253,303,556,17,4,pass
21617,1,True,98,18,116,6,4,pass
21618,1,True,21,25,46,2,1,fail
21619,1,True,0,89,89,1,1,fail
21621,1,True,129,161,290,8,1,fail
21623,1,True,0,2,2,1,1,fail
21624,1,True,5,5,10,2,1,pass
21625,2,True,8,8,16,2,2,pass
21626,1,True,5,5,10,1,1,pass
21627,1,True,3,3,6,1,1,pass
21628,1,True,202,13,215,8,3,pass
21629,2,True,202,13,215,8,3,pass
21630,2,True,450,244,694,20,4,pass
21631,1,True,34,0,34,1,1,pass
21633,1,True,2,2,4,1,1,pass
21634,1,True,1,1,2,1,1,pass
21635,2,True,250,198,448,11,3,fail
21640,1,True,5,4,9,1,1,pass
21641,1,True,90,93,183,3,1,pass
21644,2,True,5,1,6,2,2,pass
21645,1,True,5,0,5,1,1,pass
21647,2,True,133,102,235,5,1,pass
21648,1,True,60,56,116,1,1,pass
21649,1,True,22,6,28,1,1,pass
21651,2,True,102,102,204,14,5,pass
21652,1,True,4,48,52,2,1,pass
21654,1,True,1,1,2,1,1,pass
21655,1,True,35,29,64,1,1,pass
21656,1,True,2,2,4,1,1,pass
21658,1,True,4,1,5,1,1,pass
21664,1,True,1,1,2,1,1,pass
21665,1,True,3,1,4,1,1,fail
21666,1,True,19,3,22,2,1,pass
21668,2,True,456,189,645,34,5,pass
21669,1,True,16,0,16,1,1,pass
21670,1,True,5,0,5,1,1,pass
21671,1,True,2,2,4,1,1,pass
21673,1,True,1,1,2,1,1,fail
21675,1,True,2,2,4,1,1,fail
21676,1,True,1,1,2,1,1,pass
21677,2,True,1,2,3,2,2,pass
21679,1,True,1,2,3,2,2,pass
21680,1,True,2,7,9,2,2,fail
21681,1,True,3,2,5,1,1,fail
21682,1,True,1,1,2,1,1,fail
21683,1,True,277,37,314,15,2,pass
21684,2,True,1,1,2,1,1,fail
21685,1,True,42,34,76,3,2,fail
21686,1,True,3,0,3,1,1,pass
21687,1,True,2,4,6,1,1,fail
21688,1,True,1,1,2,1,1,pass
21689,2,True,236,14,250,9,3,fail
21690,1,True,17,0,17,1,1,fail
21691,1,True,37,0,37,1,1,pass
21692,1,True,17,0,17,1,1,fail
21694,1,True,10,9,19,1,1,fail
21696,1,True,1,1,2,1,1,fail
21697,1,True,20,0,20,1,1,fail
21698,1,True,1,1,2,1,1,fail
21700,1,True,126,0,126,3,2,pass
21701,1,True,3,0,3,1,1,fail
21702,1,True,14,16,30,6,2,pass
21703,1,True,18,23,41,5,1,pass
21704,1,True,1,1,2,1,1,fail
21705,1,True,2,0,2,1,1,fail
21706,1,True,48985,25353,74338,300,14,fail
21707,2,True,1,1,2,1,1,fail
21708,1,True,1,1,2,1,1,pass
21710,2,True,1,0,1,1,1,pass
21712,1,True,1,0,1,1,1,pass
21713,1,True,2,2,4,1,1,pass
21714,1,True,1,1,2,1,1,fail
21716,1,True,1,1,2,1,1,pass
21718,1,True,1,1,2,1,1,fail
21720,1,True,2,2,4,1,1,fail
21722,1,True,2,2,4,1,1,pass
21723,1,True,73,73,146,3,2,pass
21724,2,True,40,32,72,1,1,pass
21725,1,True,14,0,14,1,1,fail
21726,1,True,13,0,13,1,1,fail
21728,1,True,1,1,2,1,1,pass
21730,1,True,1,1,2,1,1,pass
21732,1,True,20,8,28,2,1,fail
21733,1,True,100,152,252,14,2,fail
21734,1,True,1,1,2,1,1,pass
21736,1,True,30,14,44,5,2,pass
21737,1,True,33,27,60,1,1,fail
21739,1,True,1,1,2,1,1,pass
21741,2,True,2601,0,2601,21,1,pass
21743,1,True,2601,0,2601,21,1,fail
21744,1,True,233,4,237,3,2,pass
21745,1,True,80,67,147,1,1,pass
21746,1,True,1,1,2,1,1,pass
21747,1,False,1,1,2,1,1,pass
21748,1,True,3,3,6,2,1,pass
21749,1,True,14,14,28,4,1,fail
21750,1,True,12,1,13,3,2,pass
21751,1,True,1,1,2,1,1,pass
21753,1,True,1,1,2,1,1,pass
21754,1,True,1,1,2,1,1,pass
21755,1,True,21,1,22,3,2,pass
21756,1,True,11,10,21,2,1,pass
21758,1,True,177,0,177,3,2,pass
21759,1,True,42,2,44,2,2,fail
21760,1,False,1,1,2,1,1,fail
21761,1,True,29,0,29,1,1,fail
21762,1,True,282,21,303,10,3,pass
21763,1,True,37,3,40,3,2,fail
21764,2,True,11,0,11,1,1,pass
21767,1,True,11,0,11,1,1,fail
21768,1,True,0,1,1,1,1,pass
21769,1,True,10,9,19,4,1,fail
21770,1,True,1,0,1,1,1,fail
21771,1,True,401,361,762,7,3,pass
21772,1,True,1,0,1,1,1,pass
21773,1,True,1,0,1,1,1,fail
21774,1,True,23,0,23,1,1,fail
21775,1,True,18,2,20,2,2,pass
21782,1,True,137,168,305,12,1,pass
21785,1,True,171,0,171,2,1,pass
21786,1,True,2055,31,2086,14,3,fail
21787,1,True,5,3,8,1,1,fail
21789,1,True,9,9,18,2,1,fail
21791,1,True,914,6,920,15,2,pass
21792,1,True,172,137,309,6,1,fail
21795,1,False,0,0,0,1,1,fail
21797,1,True,107,1,108,2,2,pass
21798,1,True,1,1,2,1,1,pass
21799,1,True,263,344,607,9,3,pass
21800,1,True,658,624,1282,6,3,fail
21802,1,True,30,28,58,1,1,pass
21803,1,True,33,7,40,2,2,pass
21804,1,True,1,1,2,1,1,pass
21806,1,True,65,1,66,10,1,pass
21807,1,True,1,1,2,1,1,pass
21808,1,True,36,8,44,5,1,pass
21809,1,True,0,51,51,1,1,pass
21810,1,True,2,2,4,1,1,pass
21811,1,True,258,222,480,32,4,fail
21812,1,True,278796,277348,556144,7,1,pass
21813,1,True,7,8,15,2,1,pass
21814,1,True,2,2,4,2,2,fail
21815,1,True,1,1,2,1,1,fail
21816,1,True,112,0,112,2,2,pass
21817,1,True,148,0,148,1,1,pass
21818,1,True,11,1,12,2,1,fail
21819,1,True,349,20,369,2,1,pass
21820,1,True,106,0,106,1,1,pass
21821,1,True,2,2,4,1,1,pass
21822,1,True,106,0,106,1,1,pass
21823,1,True,1,1,2,1,1,pass
21824,1,True,388,45,433,2,2,pass
21825,2,True,109,2,111,3,3,pass
21826,1,True,13,0,13,3,3,pass
21827,1,True,20,9,29,1,1,pass
21828,1,True,283,40,323,10,2,fail
21829,1,True,3,1,4,1,1,fail
21830,1,True,121,10,131,2,2,pass
21831,1,True,3,2,5,1,1,fail
21832,1,True,328,0,328,5,2,pass
21833,1,True,111,3,114,2,2,fail
21834,1,True,906,655,1561,9,2,pass
21835,1,True,75,46,121,3,1,fail
21836,1,True,10,8,18,4,2,pass
21837,1,True,109,2,111,3,3,pass
21838,1,True,231499,233738,465237,8,2,pass
21839,1,False,1,1,2,1,1,pass
21840,1,True,62,18,80,4,2,fail
21841,1,True,2,2,4,1,1,pass
21842,1,True,106,0,106,1,1,pass
21843,1,True,1,1,2,1,1,pass
21844,2,True,56,14,70,5,3,pass
21847,1,True,24,12,36,3,3,pass
21848,1,True,32,2,34,2,2,fail
21849,1,True,10,6,16,1,1,pass
21850,1,True,9,0,9,1,1,fail
21852,1,True,4,2,6,2,1,fail
21853,1,True,224,83,307,5,4,fail
21854,1,True,225,84,309,5,4,pass
21855,1,True,6,3,9,1,1,pass
21856,1,True,96,6,102,2,2,fail
21857,2,True,118,3,121,6,2,pass
21858,1,True,7,7,14,7,1,pass
21859,1,True,2,2,4,1,1,pass
21860,1,True,2,0,2,2,1,pass
21861,1,True,1,1,2,1,1,pass
21862,1,True,113,0,113,2,2,pass
21863,1,True,108,2,110,2,2,pass
21864,1,True,107,1,108,2,2,fail
21865,1,True,2,2,4,1,1,pass
21866,2,True,19,4,23,2,1,pass
21867,1,True,19,4,23,2,1,pass
21868,2,True,72,9,81,5,2,fail
21871,1,True,72,9,81,5,2,pass
21873,1,True,21,2,23,2,2,fail
21874,1,True,27,0,27,3,2,fail
21876,1,True,1,1,2,1,1,pass
21877,1,True,1,1,2,1,1,pass
21878,1,True,1,1,2,1,1,pass
21879,1,True,0,8,8,1,1,fail
21880,1,True,15,3,18,1,1,pass
21883,1,True,1,0,1,1,1,fail
21886,1,True,146,0,146,2,2,pass
21887,1,True,1,1,2,1,1,pass
21889,1,True,125,1,126,3,2,pass
21890,1,True,3,113,116,9,2,pass
21892,1,True,486,0,486,7,2,pass
21893,1,True,1,1,2,1,1,pass
21894,2,True,162,18083,18245,6,2,pass
21899,1,False,19,21,40,1,1,pass
21900,2,True,155,18080,18235,3,1,pass
21902,1,True,55418,49076,104494,4,2,pass
21903,1,True,155,18080,18235,3,1,pass
21904,1,True,1,1,2,1,1,pass
21905,1,True,1,1,2,1,1,pass
21907,1,True,0,4,4,1,1,pass
21909,1,True,418,102,520,9,3,pass
21910,1,True,2,1,3,1,1,pass
21911,1,True,5,7,12,1,1,pass
21914,1,True,43,8,51,3,2,pass
21915,1,True,15,3,18,1,1,pass
21917,1,True,3,2,5,1,1,pass
21921,1,True,1,1,2,1,1,pass
21922,1,True,1,1,2,1,1,pass
21923,1,True,2,2,4,1,1,pass
21925,1,True,18,3,21,2,2,pass
21926,1,True,7,0,7,1,1,pass
21928,1,True,199,271,470,14,2,pass
21929,1,True,35,5,40,5,3,pass
21930,1,True,3,3,6,1,1,pass
21931,1,True,2,1,3,1,1,pass
21932,1,True,2,2,4,1,1,pass
21933,1,True,15,16,31,1,1,pass
21934,1,True,107,1,108,2,2,pass
21935,1,True,1,1,2,1,1,pass
21936,2,True,913,799,1712,62,7,pass
21938,1,True,1,1,2,1,1,pass
21939,1,True,21382,14789,36171,3,1,pass
21940,1,True,1,1,2,1,1,pass
21941,1,True,2,2,4,1,1,pass
21942,1,True,3,3,6,1,1,fail
21943,1,True,2,3,5,1,1,fail
21944,1,True,3,3,6,1,1,fail
21945,1,True,3,3,6,1,1,fail
21947,1,True,2,2,4,1,1,fail
21948,1,True,7,3,10,2,2,pass
21949,1,True,114823,113998,228821,5,2,pass
21950,1,True,496223,154147,650370,6,2,pass
21951,1,True,1,1,2,1,1,pass
21952,1,True,2,1,3,1,1,fail
21953,1,True,2,3,5,2,2,fail
21955,1,True,2,1,3,1,1,pass
21957,1,True,0,1,1,1,1,fail
21958,1,True,0,1,1,1,1,fail
21959,2,True,4,9,13,8,3,fail
21962,1,True,2,8,10,6,2,pass
21964,1,True,1,1,2,1,1,fail
21965,1,True,2,2,4,1,1,fail
21966,1,True,108,2,110,2,2,pass
21967,1,True,130,238,368,33,6,fail
21968,1,True,8,0,8,1,1,pass
21969,1,True,10,9,19,1,1,pass
21970,1,True,706,504,1210,22,1,pass
21971,2,True,2,2,4,2,2,pass
21973,1,True,2,2,4,2,2,pass
21974,1,True,1,1,2,1,1,pass
21975,1,True,1,1,2,1,1,pass
21976,1,True,2,2,4,2,2,pass
21977,1,True,2,0,2,1,1,pass
21978,2,True,35,68,103,8,3,fail
21979,1,True,5,4,9,1,1,pass
21984,1,True,5,10,15,1,1,pass
21988,1,False,2,2,4,1,1,pass
21989,1,False,2,2,4,1,1,pass
21991,1,False,2,2,4,1,1,pass
21992,1,False,2,2,4,1,1,pass
21993,2,False,375,68,443,22,6,pass
21996,1,True,0,18,18,1,1,pass
21999,1,True,120,9,129,6,4,pass
22000,1,False,1,0,1,1,1,fail
22001,1,True,2469,1532,4001,46,5,pass
22002,1,True,2,0,2,1,1,pass
22003,1,True,391,366,757,35,2,pass
22005,1,True,0,1,1,1,1,pass
22006,1,True,25653,17881,43534,268,4,fail
22007,1,False,0,0,0,1,1,pass
22008,1,True,107,1,108,2,2,fail
22009,1,True,108,2,110,3,2,pass
22010,1,True,1,1,2,1,1,pass
22012,1,True,1011065,218751,1229816,159,9,pass
22013,1,True,22,4,26,1,1,pass
22014,2,True,2,14,16,1,1,pass
22016,1,True,2,14,16,1,1,pass
22017,1,True,107,1,108,2,2,pass
22018,1,True,127,0,127,2,2,pass
22019,1,True,1,1,2,1,1,pass
22021,1,True,123,22,145,4,3,fail
22022,1,True,2,2,4,1,1,pass
22023,1,True,15,15,30,4,2,pass
22024,1,True,2,2,4,1,1,pass
22025,1,True,2278,1717,3995,109,3,pass
22026,1,True,37,30,67,8,4,pass
22027,1,True,406,451,857,4,4,pass
22029,1,True,2,2,4,2,2,pass
22031,1,True,49,1,50,2,1,pass
22033,1,True,40,47,87,10,2,pass
22035,1,True,591989,1,591990,13,3,pass
22037,1,True,53,39,92,2,1,pass
22038,1,True,150,1,151,3,2,pass
22040,1,True,7,0,7,1,1,pass
22042,2,True,334,5,339,7,2,pass
22044,1,True,5,0,5,1,1,pass
22045,1,True,5,1,6,2,2,fail
22047,1,True,87,0,87,1,1,fail
22048,1,True,2,2,4,1,1,pass
22049,1,True,2,1,3,1,1,pass
22050,1,True,29,12,41,2,1,fail
22051,1,True,211,2,213,4,1,pass
22052,1,True,6,1,7,1,1,pass
22053,1,True,88,5,93,2,2,pass
22054,1,True,1,1,2,1,1,pass
22055,1,True,1,2,3,1,1,fail
22056,1,True,7,1,8,2,2,fail
22058,1,True,0,251,251,1,1,fail
22059,1,True,3,0,3,1,1,pass
22062,1,True,138,0,138,2,2,pass
22063,1,True,1,1,2,1,1,pass
22064,1,True,108,2,110,2,2,pass
22065,1,True,2,2,4,1,1,fail
22067,1,True,14,0,14,1,1,pass
22069,1,True,2,2,4,1,1,fail
22070,1,True,8,11,19,1,1,fail
22071,1,True,39,28,67,1,1,fail
22080,1,True,2,2,4,1,1,pass
22081,1,True,142,39,181,2,2,pass
22082,1,True,3,3,6,3,2,pass
22083,1,True,2,2,4,2,2,pass
22084,1,True,2,2,4,2,2,fail
22085,1,True,2,2,4,1,1,pass
22086,1,True,27,0,27,1,1,pass
22087,1,True,1,1,2,1,1,pass
22088,1,True,1,1,2,1,1,pass
22089,1,True,1,1,2,1,1,pass
22090,2,True,160,22,182,13,6,pass
22092,1,True,43,11,54,4,2,pass
22093,1,True,116,10,126,8,4,pass
22094,1,True,1,1,2,1,1,pass
22096,1,True,2,2,4,1,1,pass
22097,1,True,2,2,4,1,1,pass
22098,1,True,1,1,2,1,1,pass
22099,1,True,1,1,2,1,1,pass
22101,1,True,1,1,2,1,1,fail
22105,1,True,8,8,16,2,2,pass
22107,1,True,1,0,1,1,1,fail
22110,1,True,14,6,20,2,2,fail
22113,1,True,1,0,1,1,1,fail
22114,1,True,47,14,61,2,1,fail
22117,2,True,42,22,64,8,4,pass
22120,1,True,3,3,6,1,1,fail
22121,1,True,1,0,1,1,1,pass
22125,1,True,3,3,6,1,1,pass
22126,1,True,2,2,4,1,1,pass
22128,1,True,397498,217125,614623,16,1,pass
22130,1,True,0,83,83,1,1,pass
22131,1,True,1,0,1,1,1,pass
22132,1,True,15402,107,15509,16,2,pass
22133,1,True,1,1,2,1,1,pass
22134,1,True,122,16,138,2,2,pass
22136,1,True,41,20,61,5,1,pass
22137,1,True,2,2,4,2,2,pass
22140,1,True,2,2,4,2,2,fail
22141,1,True,0,13,13,1,1,fail
22142,1,True,2,0,2,1,1,fail
22143,2,True,1333,401,1734,13,5,fail
22147,1,True,61,12,73,19,1,pass
22148,1,True,1250,361,1611,5,3,pass
22149,1,True,1,1,2,1,1,pass
22150,1,True,81,38,119,6,1,pass
22151,1,True,1,1,2,1,1,pass
22152,1,True,2,2,4,1,1,fail
22154,2,True,47,42,89,6,1,fail
22156,1,True,2,2,4,2,2,pass
22157,1,True,46,41,87,5,1,fail
22159,1,True,1,1,2,1,1,fail
22160,1,True,2,0,2,2,2,fail
22162,1,False,3,4,7,1,1,fail
22163,2,True,287,8,295,2,2,fail
22165,1,True,287,8,295,2,2,fail
22166,1,True,1,1,2,1,1,fail
22167,2,True,3435,913,4348,60,6,fail
22168,1,True,0,1,1,1,1,fail
22169,1,True,2,2,4,1,1,fail
22170,1,True,106,0,106,1,1,fail
22171,1,True,106,0,106,1,1,fail
22172,1,True,107,1,108,2,2,fail
22173,1,False,4,0,4,1,1,fail
22182,2,True,233,2,235,7,3,fail
22184,1,False,1,0,1,1,1,fail
22199,1,True,232,1,233,6,2,pass
22202,1,True,3,3,6,1,1,fail
22213,1,True,3,3,6,3,2,pass
22214,1,True,495,1,496,1,1,pass
22215,1,True,22,20,42,2,2,fail
22217,1,True,19,0,19,1,1,fail
22218,1,True,114,12,126,2,2,pass
22219,1,True,2,1,3,1,1,fail
22220,1,True,13,2,15,2,1,fail
22223,1,True,898,820,1718,9,2,pass
22224,1,True,114,6,120,2,2,pass
22226,1,True,20,5,25,1,1,fail
22229,1,True,1,1,2,1,1,fail
22232,1,True,16,8,24,1,1,fail
22233,1,True,15,9,24,1,1,fail
22236,1,True,2,2,4,1,1,fail
22241,1,True,1,1,2,1,1,pass
22243,1,True,1,1,2,1,1,pass
22244,1,True,351,30,381,6,3,pass
22245,1,True,138,0,138,2,2,pass
22246,1,True,238,0,238,5,2,pass
22247,1,True,106,0,106,1,1,pass
22248,1,True,1,1,2,1,1,pass
22249,1,True,0,263,263,1,1,fail
22251,1,True,110,2,112,2,2,pass
22252,1,True,115,5,120,3,2,pass
22253,1,True,117,2,119,2,2,pass
22254,1,True,2,2,4,2,1,fail
22259,1,True,0,6,6,1,1,pass
22260,1,True,1,0,1,1,1,pass
22261,1,True,1,1,2,1,1,pass
22262,1,True,116,0,116,1,1,fail
22263,1,True,54,0,54,1,1,pass
22264,2,True,19,5,24,5,3,pass
22267,2,True,9,4,13,3,2,fail
22270,1,True,4,0,4,1,1,fail
22274,1,True,1,1,2,1,1,pass
22275,1,True,3,0,3,1,1,pass
22276,1,True,1,0,1,1,1,pass
22277,1,True,12,3,15,2,2,pass
22278,1,True,4,2,6,1,1,pass
22280,1,True,1,1,2,1,1,pass
22281,1,True,3,0,3,1,1,pass
22284,1,True,2,2,4,1,1,fail
22285,1,True,44,5,49,7,1,fail
22288,1,True,4,0,4,1,1,fail
22291,2,True,6249,2957,9206,63,8,fail
22293,1,True,3115,2880,5995,13,1,pass
22294,1,True,108,2,110,2,2,pass
22295,1,False,1,1,2,1,1,pass
22297,1,False,1,1,2,1,1,pass
22300,1,False,1,1,2,1,1,pass
22302,1,True,127,1,128,2,2,pass
22306,1,True,119,8,127,2,2,pass
22307,1,True,37,0,37,2,2,pass
22308,1,True,6,33,39,4,1,pass
22309,2,False,20,7,27,5,3,pass
22311,1,True,11,5,16,3,3,pass
22312,1,True,9,2,11,2,1,pass
22313,1,False,11,0,11,1,1,pass
22314,1,False,48,0,48,1,1,pass
22316,1,True,115,7,122,2,2,pass
22317,1,True,106,0,106,1,1,pass
22318,1,True,2,2,4,1,1,pass
22319,1,True,1,1,2,1,1,pass
22320,1,True,2,2,4,1,1,pass
22321,1,True,65,5,70,1,1,pass
22322,1,True,34,1,35,1,1,pass
22323,1,True,1,1,2,1,1,pass
22324,1,True,2006,1,2007,6,1,pass
22325,1,False,1,1,2,1,1,pass
22326,1,True,2117,3775,5892,218,5,pass
22327,1,True,11,21,32,3,2,fail
22328,1,True,9,7,16,1,1,pass
22330,1,False,0,1,1,1,1,pass
22332,1,False,2,2,4,1,1,pass
22333,1,False,21,6,27,4,1,fail
22334,2,False,120,2,122,3,2,fail
22337,1,True,13,1,14,1,1,fail
22338,1,True,106,0,106,1,1,fail
22339,2,False,117,7,124,7,2,pass
22342,1,False,75,0,75,3,1,pass
22344,2,True,390607,20887,411494,23,5,fail
22345,1,False,15,0,15,1,1,pass
22347,1,False,2,2,4,1,1,pass
22349,1,False,12,3,15,1,1,pass
22350,1,False,3,3,6,2,2,pass
22351,1,False,3,3,6,2,2,pass
22352,1,False,16,0,16,1,1,fail
22353,1,False,1,3,4,1,1,fail
22354,1,False,2,2,4,2,2,fail
22355,1,True,390451,20877,411328,16,2,pass
22356,1,True,133,1,134,2,2,pass
22357,2,True,1,2,3,2,2,fail
22359,1,False,1,0,1,1,1,pass
22360,1,True,273,5,278,6,2,fail
22361,2,True,98,1,99,3,1,fail
22362,1,True,98,1,99,3,1,pass
22363,2,True,15444,100171,115615,22,2,fail
22364,1,True,15444,100171,115615,22,2,pass
22365,2,True,302,14,316,11,4,fail
22367,1,True,49,0,49,1,1,pass
22368,1,True,127,0,127,2,2,pass
22369,1,True,25,1,26,3,1,pass
22371,2,True,101509,5,101514,17,4,fail
22372,1,True,101477,1,101478,14,2,pass
22374,1,True,1,1,2,1,1,pass
22376,1,True,20,0,20,1,1,pass
22377,2,True,414,2,416,4,2,fail
22378,1,True,389,2,391,2,1,pass
22379,1,True,23,0,23,2,2,pass
22380,1,True,9,0,9,1,1,fail
22382,2,True,2,1,3,1,1,fail
22384,1,True,2,1,3,1,1,fail
22385,1,True,4,4,8,1,1,fail
22386,1,True,4,0,4,1,1,fail
22387,2,True,213,214,427,1,1,fail
22389,1,True,0,1,1,1,1,fail
22390,1,True,213,213,426,1,1,fail
22391,1,True,4,30,34,1,1,fail
22393,1,True,0,1,1,1,1,pass
22394,1,True,1,2,3,2,2,fail
22398,1,True,1,0,1,1,1,fail
22399,2,True,31968,304,32272,57,8,fail
22400,1,True,8,13,21,1,1,fail
22401,1,True,1,1,2,1,1,pass
22402,1,True,1,1,2,1,1,fail
22403,1,True,107,1,108,2,2,pass
22404,1,True,33,23,56,1,1,fail
22405,1,True,2,2,4,1,1,fail
22406,1,True,2,1,3,1,1,fail
22407,1,True,1,1,2,1,1,fail
22408,1,True,2,2,4,1,1,fail
22409,1,True,1,6,7,1,1,fail
22410,1,True,10,1,11,1,1,fail
22411,1,True,1,1,2,1,1,fail
22412,1,True,1,1,2,1,1,fail
22413,2,True,41,14,55,6,3,fail
22415,1,False,9,3,12,1,1,pass
22416,1,True,1,1,2,1,1,fail
22417,1,True,9,10,19,1,1,fail
22418,1,True,3,1,4,2,1,fail
22420,1,True,3,1,4,1,1,fail
22421,1,True,2,1,3,1,1,fail
22422,1,True,23,0,23,1,1,fail
22424,1,True,3,2,5,1,1,fail
22425,1,True,1,1,2,1,1,fail
22426,2,True,7,7,14,1,1,fail
22428,2,True,25,17,42,3,2,fail
22431,1,True,1,1,2,1,1,fail
22432,1,True,1,1,2,1,1,fail
22434,1,True,3,1,4,1,1,fail
22435,1,True,1,1,2,1,1,fail
22436,1,True,6,5,11,1,1,fail
22437,1,True,9,8,17,1,1,fail
22438,1,True,23,5,28,3,1,pass
22439,1,True,1,1,2,1,1,fail
22440,1,True,1,0,1,1,1,fail
22441,1,True,1,0,1,1,1,fail
22442,1,True,1,1,2,1,1,fail
22443,2,True,638,9,647,13,5,fail
22446,1,True,29945,1,29946,11,2,pass
22447,1,True,2,3,5,2,2,pass
22448,1,True,515,3,518,11,2,pass
22449,1,False,6,6,12,2,2,pass
22450,1,True,108,2,110,2,2,fail
22451,1,True,1,1,2,1,1,fail
22454,1,True,1249,276,1525,21,4,pass
22455,1,True,1,1,2,1,1,pass
22456,2,True,526,7,533,9,5,pass
22457,1,True,112,2,114,4,3,pass
22459,1,True,36,0,36,1,1,pass
22460,1,True,108,0,108,2,2,pass
22461,1,True,108,2,110,3,2,pass
22462,1,True,108,2,110,2,2,pass
22463,1,True,268,0,268,2,2,pass
22464,2,True,952,95,1047,26,5,pass
22466,1,True,4,0,4,1,1,pass
22467,2,True,32,3,35,2,2,pass
22468,1,False,2,2,4,1,1,pass
22470,1,False,29,1,30,1,1,pass
22471,2,True,147,4,151,4,4,pass
22472,1,True,145,3,148,3,3,pass
22473,1,False,2,1,3,1,1,pass
22474,2,True,138,2,140,4,2,pass
22475,1,True,138,2,140,4,2,pass
22476,1,True,1,0,1,1,1,pass
22477,1,True,3,2,5,1,1,pass
22478,2,True,632,85,717,16,3,pass
22479,1,True,106,0,106,1,1,pass
22480,1,True,1,1,2,1,1,pass
22481,2,False,119,13,132,3,3,pass
22483,1,True,118,12,130,2,2,pass
22484,1,True,1,1,2,1,1,pass
22485,1,False,3,1,4,1,1,pass
22486,1,True,161,30,191,4,2,pass
22487,1,True,71,3,74,4,1,pass
22488,2,True,21,1,22,3,1,pass
22490,1,True,21,1,22,3,1,pass
22491,1,True,2,2,4,2,2,pass
22492,2,True,117,27,144,12,3,pass
22494,1,True,107,1,108,2,2,pass
22495,2,True,6,5,11,2,2,pass
22496,1,True,5,5,10,1,1,pass
22497,1,True,52,19,71,9,2,pass
22499,2,True,59,3,62,2,2,pass
22500,2,True,48,74,122,7,3,pass
22501,1,True,48,74,122,7,3,pass
22502,1,True,3,3,6,3,2,pass
22504,2,True,52,10,62,4,2,pass
22505,1,False,35,10,45,2,2,pass
22507,1,True,2,9,11,2,2,fail
22509,1,True,6,0,6,1,1,pass
22510,2,True,3,1,4,2,1,pass
22513,1,True,2,1,3,1,1,pass
22514,2,True,16,25,41,1,1,pass
22516,1,True,854,788,1642,16,5,pass
22517,1,True,1,1,2,1,1,fail
22518,1,True,2,0,2,1,1,fail
22520,1,True,1,1,2,1,1,fail
22522,1,True,2,2,4,2,2,fail
22523,2,True,316863,82,316945,64,9,fail
22524,1,True,1,1,2,1,1,fail
22526,1,True,2,2,4,2,2,fail
22528,1,False,0,1,1,1,1,pass
22529,1,True,595,11,606,12,2,fail
22530,1,True,314860,1,314861,6,1,pass
22531,1,True,107,1,108,2,2,pass
22532,1,True,1,3,4,1,1,fail
22533,1,True,1,1,2,1,1,fail
22534,1,True,3,1,4,1,1,fail
22535,1,True,1,1,2,1,1,fail
22536,1,True,1,0,1,1,1,fail
22537,1,True,57,57,114,1,1,fail
22538,1,True,3,0,3,1,1,fail
22539,1,True,2,1,3,1,1,fail
22541,1,True,139,0,139,2,2,pass
22542,1,True,106,0,106,1,1,pass
22543,1,True,3,3,6,1,1,pass
22544,1,True,115,9,124,2,2,pass
22546,1,True,4,6,10,1,1,fail
22547,1,True,2,0,2,1,1,fail
22548,1,True,1,1,2,1,1,fail
22549,1,True,11,6,17,1,1,fail
22557,1,False,23,24,47,1,1,pass
22560,1,False,19,20,39,11,2,pass
22562,2,False,109,3,112,2,2,pass
22566,1,True,106,0,106,1,1,pass
22570,1,True,25,16,41,1,1,fail
22574,1,True,3,3,6,1,1,pass
22575,1,False,0,0,0,5,1,pass
22576,1,True,72,0,72,5,1,pass
22577,1,True,125,1,126,3,3,pass
22578,1,True,193,17,210,4,1,pass
22579,1,True,139,8,147,3,3,pass
22580,1,True,1,1,2,1,1,pass
22581,1,False,4,6,10,3,2,pass
22584,1,True,1,1,2,1,1,pass
22585,1,True,2,2,4,1,1,fail
22587,1,True,88,1,89,2,2,pass
22591,2,True,298,61,359,15,7,fail
22592,1,True,2,2,4,1,1,fail
22601,1,True,1,1,2,1,1,fail
22602,1,True,123,2,125,3,3,pass
22604,1,True,130,0,130,2,2,pass
22605,1,False,1,1,2,1,1,pass
22606,1,False,44,58,102,9,4,pass
22608,1,True,315,0,315,1,1,fail
22617,1,True,2933,1897,4830,75,8,pass
22618,1,False,13,9,22,1,1,pass
22619,1,False,27,0,27,4,2,pass
22622,1,False,10,0,10,2,2,pass
22623,1,True,107,1,108,2,2,pass
22624,1,True,0,1,1,1,1,pass
22625,1,True,106,1,107,2,2,pass
22627,1,True,59,3,62,2,2,pass
22628,1,False,19,19,38,1,1,pass
22629,1,False,1,1,2,1,1,pass
22630,1,True,3,3,6,2,2,pass
22631,1,True,3,3,6,1,1,pass
22632,1,False,4,4,8,1,1,pass
22633,1,False,1,1,2,1,1,pass
22634,2,False,12,7,19,3,2,pass
22636,1,False,5,3,8,1,1,pass
22640,1,False,3,3,6,2,1,fail
22642,1,False,1,1,2,1,1,pass
22643,1,False,16,23,39,1,1,pass
22644,1,False,23,16,39,1,1,fail
22645,1,False,1,1,2,1,1,pass
22646,1,False,1,1,2,1,1,pass
22648,1,True,3,2,5,1,1,pass
22649,1,True,692536,0,692536,4,2,pass
22650,1,False,12,10,22,1,1,pass
22651,1,False,1,12,13,2,1,pass
22652,2,False,18,13,31,4,2,fail
22653,1,False,2,2,4,1,1,pass
22654,1,False,3,1,4,1,1,pass
22655,1,False,1,1,2,1,1,pass
22656,1,False,9,9,18,1,1,pass
22659,1,False,16,15,31,4,2,pass
22660,1,False,2,2,4,1,1,pass
22661,1,False,4,2,6,1,1,pass
22662,1,False,84,17,101,6,2,fail
22666,1,True,652,443,1095,41,3,pass
22669,1,False,112,6,118,2,1,pass
22670,1,True,45,17,62,3,3,pass
22671,1,True,112,0,112,2,2,pass
22672,1,False,1,1,2,1,1,pass
22673,1,False,22,1,23,1,1,fail
22674,2,False,48,25,73,9,3,pass
22676,2,True,48,25,73,9,3,pass
22677,1,True,2172,0,2172,5,2,pass
22678,1,True,2,2,4,2,2,fail
22679,2,True,12,12,24,5,3,pass
22681,1,True,12,12,24,5,3,fail
22682,1,True,21,13,34,3,1,fail
22683,2,True,33,7,40,3,2,pass
22684,2,True,120,33,153,10,2,pass
22685,1,True,2,1,3,1,1,pass
22686,1,False,16,3,19,2,2,pass
22687,1,True,1,0,1,1,1,fail
22690,1,True,7,0,7,1,1,pass
22692,1,True,1,4,5,1,1,fail
22695,1,True,3,2,5,1,1,fail
22696,1,True,12,0,12,1,1,fail
22697,1,True,0,1,1,1,1,fail
22698,1,True,3,1,4,1,1,fail
22699,1,True,1,0,1,1,1,fail
22701,1,True,100,32,132,7,2,fail
22702,1,True,1,0,1,1,1,pass
22706,1,False,1,2,3,1,1,pass
22707,1,False,1,6,7,4,3,fail
22708,1,False,9,1,10,1,1,pass
22709,1,False,7,11,18,4,2,pass
22710,1,False,2,1,3,1,1,pass
22711,1,False,1,1,2,1,1,pass
22714,1,False,2,1,3,1,1,pass
22716,1,True,12,0,12,2,2,fail
22717,1,True,3,0,3,1,1,fail
22718,1,True,4765,1006,5771,67,7,fail
22721,2,True,7,1,8,1,1,fail
22722,1,True,7,1,8,1,1,fail
22723,1,False,2,22,24,1,1,pass
22726,2,False,104,3,107,2,1,pass
22728,2,True,88,0,88,1,1,pass
22729,1,True,5,4,9,1,1,fail
22731,1,True,8,9,17,1,1,fail
22733,1,True,2,2,4,1,1,fail
22734,1,True,7,3,10,1,1,fail
22738,1,True,88,0,88,1,1,pass
22739,1,True,17,0,17,1,1,fail
22741,1,True,2,2,4,1,1,fail
22742,1,True,2,2,4,2,2,fail
22743,2,True,16,3,19,1,1,pass
22744,1,False,1,1,2,1,1,pass
22745,2,False,1317,141,1458,27,5,pass
22747,1,False,317,120,437,4,1,pass
22750,1,False,848,0,848,8,1,pass
22751,1,False,82,0,82,1,1,pass
22754,2,False,0,0,0,0,0,pass
22756,2,True,337,2,339,6,2,pass
22758,2,True,0,0,0,0,0,pass
22760,1,True,16,3,19,1,1,pass
22761,2,True,15,0,15,1,1,pass
22762,1,True,5,5,10,1,1,pass
22764,1,True,15,0,15,1,1,pass
22765,2,True,188,0,188,2,2,pass
22767,1,True,26,0,26,1,1,fail
22768,1,True,2,2,4,1,1,pass
22769,1,True,106,0,106,1,1,pass
22770,1,True,82,0,82,1,1,pass
22771,2,False,332,11,343,10,3,pass
22773,2,True,107,1,108,2,2,pass
22774,1,True,112,5,117,2,2,pass
22775,1,True,106,0,106,1,1,pass
22777,2,True,106,0,106,1,1,pass
22778,2,True,2,2,4,2,1,pass
22779,1,True,1,1,2,1,1,pass
22780,1,True,106,0,106,1,1,pass
22783,2,True,1,1,2,1,1,pass
22784,1,True,1,1,2,1,1,pass
22786,2,True,4,2,6,2,2,pass
22787,1,True,3,1,4,1,1,pass
22789,1,True,417,231,648,21,5,pass
22790,2,False,108,2,110,2,2,pass
22792,2,True,108,2,110,2,2,fail
22793,1,False,2,2,4,2,2,fail
22794,1,False,41,0,41,1,1,fail
22795,1,False,2,1,3,1,1,pass
22796,1,False,9,0,9,1,1,pass
22799,1,False,1,1,2,1,1,pass
22800,1,False,3,1,4,1,1,fail
22801,2,True,64,49,113,6,4,pass
22803,1,True,2,2,4,2,2,fail
22804,1,True,2,2,4,2,2,fail
22805,1,True,1,1,2,1,1,fail
22806,1,True,10,10,20,1,1,fail
22807,2,True,81,5,86,5,2,fail
22808,1,True,106,0,106,1,1,pass
22809,1,True,2,2,4,1,1,pass
22810,1,False,1,1,2,1,1,pass
22811,1,False,76,1,77,3,2,pass
22812,2,True,1,1,2,1,1,pass
22813,1,False,76,1,77,3,2,pass
22815,1,True,4,2,6,1,1,fail
22816,1,False,1,1,2,1,1,pass
22819,1,True,1,0,1,1,1,pass
22820,1,True,0,1,1,1,1,pass
22822,1,True,1,1,2,1,1,fail
22824,1,True,1,0,1,1,1,fail
22825,1,True,1,1,2,1,1,fail
22828,1,False,1,0,1,1,1,pass
22829,1,False,1,1,2,1,1,fail
22830,2,False,116,8,124,3,2,fail
22832,2,True,116,8,124,3,2,fail
22833,1,False,4,9,13,1,1,fail
22834,1,False,1,1,2,1,1,fail
22835,1,False,2,0,2,1,1,fail
22836,1,False,74,0,74,1,1,fail
22839,1,False,1,1,2,1,1,pass
22845,1,False,0,14,14,1,1,pass
22848,2,True,317,120,437,4,1,pass
22849,1,True,9,9,18,1,1,pass
22850,1,True,20,5,25,1,1,fail
22851,2,True,108,2,110,3,2,pass
22860,1,True,1,1,2,1,1,pass
22861,1,True,106,0,106,1,1,pass
22862,1,True,1,1,2,1,1,pass
22863,1,False,27,23,50,1,1,pass
22864,1,False,13,1,14,1,1,pass
22866,1,False,4,1,5,1,1,pass
22867,1,False,2,1,3,1,1,pass
22868,1,False,3,4,7,1,1,fail
22869,1,False,6,5,11,1,1,pass
22870,1,False,5,5,10,1,1,pass
22871,2,False,2,2,4,1,1,pass
22873,2,True,2,2,4,1,1,pass
22874,1,False,1,1,2,1,1,pass
22875,1,False,11,13,24,1,1,pass
22876,1,False,2,1,3,1,1,pass
22877,1,False,1,1,2,1,1,fail
22878,1,False,1,0,1,1,1,fail
22879,1,False,6,3,9,1,1,pass
22880,1,False,1,2,3,1,1,fail
22881,1,False,1,0,1,1,1,pass
22882,1,False,1,1,2,1,1,fail
22883,1,False,11,0,11,1,1,pass
22884,1,True,2,2,4,1,1,pass
22885,1,False,1,0,1,1,1,fail
22886,2,False,173,13,186,1,1,fail
22888,2,True,173,13,186,1,1,pass
22889,1,False,1,1,2,1,1,pass
22890,1,False,1,1,2,1,1,fail
22906,1,False,1,2,3,1,1,pass
22916,1,False,169,169,338,1,1,pass
22919,1,False,197,197,394,1,1,fail
22920,1,False,67,67,134,1,1,fail
22921,1,False,245,245,490,1,1,pass
22923,1,False,1,0,1,1,1,fail
22925,1,False,1,1,2,1,1,fail
22926,1,False,15,2,17,1,1,fail
22927,1,False,1,1,2,1,1,fail
22928,1,False,3,2,5,1,1,fail
22929,1,False,2,0,2,2,2,fail
22930,1,False,4,4,8,1,1,fail
22931,1,False,1,1,2,1,1,fail
22932,1,True,173,13,186,1,1,pass
22933,2,True,566,130,696,9,2,fail
22934,1,True,0,36,36,1,1,fail
22935,2,True,623,220,843,7,2,fail
22936,2,True,1639,5,1644,7,4,fail
22937,2,True,1637,3,1640,5,3,fail
22938,1,True,3,11,14,1,1,fail
22939,1,True,16,6,22,1,1,fail
22942,1,False,1,1,2,1,1,pass
22943,1,False,2,2,4,2,2,pass
22944,1,True,114,61,175,1,1,fail
22945,1,False,2,2,4,2,2,pass
22946,1,True,2,0,2,1,1,pass
22947,1,True,3,3,6,1,1,fail
22948,1,True,7,7,14,1,1,fail
22949,1,True,106,0,106,1,1,pass
22950,1,True,1,1,2,1,1,fail
22953,1,True,7,4,11,1,1,fail
22959,1,True,2,2,4,1,1,fail
22960,1,True,236,0,236,1,1,fail
22967,2,True,1630,0,1630,2,1,pass
22968,2,True,1,1,2,1,1,fail
22969,1,True,1,1,2,1,1,pass
22970,2,True,6,2,8,2,2,pass
22972,1,True,3,2,5,1,1,fail
22974,2,False,21,0,21,3,1,pass
22979,2,True,54,9,63,2,2,pass
22980,1,False,22,4,26,1,1,pass
22981,1,False,4,2,6,2,2,pass
22982,1,False,2,2,4,1,1,pass
22983,2,True,12,1,13,2,1,pass
22984,1,True,0,1,1,1,1,fail
22986,1,False,10,0,10,2,1,pass
22988,2,True,4,2,6,2,2,pass
22989,1,False,2,2,4,1,1,pass
22990,1,False,35,331,366,5,3,pass
22993,1,False,14,7,21,2,1,pass
22998,1,False,2,2,4,1,1,pass
23000,2,True,130,1,131,3,2,pass
23001,1,False,15,4,19,1,1,pass
23002,2,True,2,1,3,1,1,pass
23003,1,False,2,1,3,1,1,pass
23004,1,True,5,7,12,1,1,fail
23005,1,True,1,1,2,1,1,fail
23008,1,False,16,0,16,1,1,fail
23010,1,True,17,1,18,1,1,pass
23012,1,True,22,42,64,1,1,fail
23018,2,True,38,9,47,8,3,pass
23019,2,True,142,5,147,6,3,pass
23020,2,True,4,4,8,3,1,pass
23021,1,True,25,8,33,1,1,pass
23022,1,True,1,1,2,1,1,fail
23025,1,True,36,5,41,5,2,pass
23029,2,True,115,11,126,4,2,pass
23030,1,True,5,6,11,2,1,fail
23034,1,True,109,3,112,2,2,pass
23036,1,True,37,38,75,1,1,pass
23038,1,True,13,8,21,1,1,pass
23039,1,True,5,4,9,1,1,pass
23045,1,True,6,1,7,1,1,pass
23051,1,False,1,1,2,1,1,pass
23052,2,True,112,5,117,2,2,pass
23053,1,True,1,1,2,1,1,pass
23054,1,True,106,0,106,1,1,pass
23055,1,True,6,5,11,1,1,pass
23056,1,True,1,1,2,1,1,pass
23060,2,False,1,1,2,1,1,fail
23064,2,True,1,1,2,1,1,pass
23065,1,True,1,1,2,1,1,pass
23066,2,False,116,10,126,6,2,pass
23068,1,True,2,2,4,1,1,pass
23070,1,False,5,5,10,2,1,pass
23073,2,True,109,3,112,3,2,pass
23074,1,True,1,1,2,1,1,pass
23076,1,True,106,0,106,1,1,pass
23077,1,True,2,2,4,1,1,pass
23078,1,False,13,11,24,1,1,pass
23079,2,False,83,10,93,11,4,pass
23084,2,True,49,0,49,2,1,pass
23085,1,True,1,1,2,1,1,pass
23086,1,True,43,1,44,2,1,pass
23087,2,True,21,1,22,2,1,pass
23088,2,True,3,3,6,2,2,pass
23089,1,True,1,1,2,1,1,pass
23091,2,True,2,2,4,1,1,pass
23092,1,True,2,2,4,1,1,pass
23093,1,False,1,0,1,1,1,pass
23094,1,False,2,2,4,1,1,pass
23095,1,False,2,2,4,1,1,pass
23096,2,False,24,0,24,3,3,pass
23098,2,False,5,0,5,1,1,pass
23102,2,False,20,3,23,4,2,pass
23103,1,False,5,2,7,1,1,pass
23104,1,True,19,0,19,1,1,pass
23107,1,True,1,1,2,1,1,pass
23108,1,False,1,1,2,1,1,pass
23109,1,False,1,1,2,1,1,fail
23110,1,True,7,0,7,1,1,pass
23111,1,False,14,0,14,2,1,fail
23112,1,False,1,1,2,1,1,pass
23113,2,True,107,1,108,2,2,pass
23114,1,True,0,8,8,1,1,fail
23115,1,True,115,1,116,3,2,pass
23116,2,True,20984,0,20984,5,2,pass
23117,2,True,150,0,150,3,1,pass
23118,1,False,2,2,4,1,1,pass
23119,2,True,151,2,153,4,4,pass
23120,1,False,1,1,2,1,1,pass
23121,1,True,106,0,106,1,1,fail
23124,1,False,2,2,4,1,1,pass
23125,1,True,58,23,81,3,1,pass
23127,1,True,1,1,2,1,1,pass
23129,1,True,0,44,44,1,1,pass
23130,1,True,5,2,7,1,1,pass
23131,1,True,106,0,106,1,1,pass
23132,2,True,330,34,364,5,3,pass
23133,2,True,110,3,113,2,2,pass
23134,1,False,18,0,18,1,1,pass
23136,1,True,3271,3271,6542,1,1,pass
23137,1,True,231,29,260,1,1,pass
23140,1,False,13,0,13,1,1,pass
23142,1,True,2,2,4,1,1,pass
23143,1,True,107,111,218,1,1,fail
23144,1,False,2,2,4,1,1,pass
23145,1,False,2,0,2,1,1,pass
23148,1,True,2,2,4,1,1,pass
23149,1,True,106,0,106,1,1,pass
23150,1,True,5,4,9,1,1,pass
23151,1,False,1,0,1,1,1,pass
23152,1,True,1,1,2,1,1,fail
23153,1,True,4,2,6,1,1,fail
23154,1,True,1,5,6,1,1,fail
23156,1,False,19,0,19,1,1,fail
23158,2,False,108,0,108,2,2,pass
23161,2,True,108,0,108,2,2,pass
23162,2,True,0,0,0,0,0,pass
23165,2,True,2,4,6,1,1,fail
23166,1,False,85,0,85,1,1,pass
23167,1,False,18,11,29,2,1,pass
23171,1,True,106,0,106,1,1,pass
23178,2,True,56,0,56,6,2,pass
23180,1,True,56,0,56,6,2,pass
23182,1,False,1,1,2,1,1,pass
23185,1,False,1,0,1,1,1,pass
23186,1,False,11,6,17,1,1,fail
23188,2,True,2,2,4,1,1,pass
23189,1,True,2,2,4,1,1,pass
23190,2,False,25,9,34,4,2,pass
23192,1,False,5,0,5,1,1,fail
23193,1,False,1,1,2,1,1,fail
23194,1,False,8,7,15,1,1,fail
23195,2,False,4,0,4,1,1,pass
23197,2,False,2,3,5,1,1,pass
23199,2,False,54,2,56,2,1,pass
23203,1,False,15,0,15,2,2,pass
23204,2,True,55,49,104,1,1,pass
23205,1,True,33,19,52,1,1,pass
23210,2,True,183,16,199,10,3,pass
23211,1,False,2,1,3,1,1,pass
23213,1,True,40,40,80,1,1,pass
23214,2,True,55,34,89,4,2,pass
23215,2,True,106,0,106,1,1,fail
23216,1,True,0,0,0,1,1,pass
23219,2,True,1,1,2,1,1,pass
23220,2,True,107,1,108,2,2,pass
23221,1,True,106,0,106,1,1,pass
23223,1,True,1,1,2,1,1,pass
23224,2,True,174,22,196,21,3,pass
23225,2,True,16,20,36,14,1,pass
23226,1,True,1,1,2,1,1,fail
23232,1,True,0,1,1,1,1,pass
23233,1,True,3,4,7,3,1,pass
23234,1,True,13,15,28,12,1,pass
23235,2,True,123,2,125,4,2,pass
23236,1,True,1,1,2,1,1,pass
23237,1,False,5,0,5,1,1,pass
23240,1,True,19,13,32,1,1,pass
23241,2,True,10,10,20,10,1,fail
23243,1,True,4,0,4,1,1,pass
23244,1,True,22,19,41,1,1,pass
23245,1,True,10,10,20,10,1,pass
23246,1,True,1,0,1,1,1,fail
23247,1,False,30,1,31,1,1,fail
23248,2,True,1,1,2,1,1,pass
23249,1,True,1,1,2,1,1,pass
23252,1,False,3,3,6,1,1,pass
23253,1,False,1,0,1,1,1,pass
23254,2,False,117,4,121,4,2,pass
23256,2,True,3,3,6,1,1,pass
23257,2,True,1,1,2,1,1,pass
23258,1,True,1,1,2,1,1,pass
23259,1,True,1,1,2,1,1,pass
23260,1,True,2,2,4,1,1,pass
23262,2,True,113,0,113,2,2,pass
23263,1,True,106,0,106,1,1,pass
23265,2,True,270,60,330,4,1,pass
23266,1,False,1,0,1,1,1,pass
23267,2,False,1338144,3,1338147,10,2,fail
23269,1,True,1,1,2,1,1,pass
23270,2,True,0,0,0,0,0,fail
23271,2,True,1338152,11,1338163,11,3,fail
23272,2,True,108,2,110,3,2,fail
23273,2,True,1338036,1,1338037,7,2,fail
23274,1,False,0,0,0,1,1,pass
23275,2,True,9,9,18,1,1,pass
23276,1,True,9,9,18,1,1,pass
23277,1,True,3,8,11,1,1,pass
23279,2,True,1,1,2,1,1,pass
23281,1,True,1,1,2,1,1,pass
23282,1,True,1,1,2,1,1,pass
23283,2,True,108,2,110,2,2,pass
23284,1,True,106,0,106,1,1,pass
23286,2,True,106,0,106,1,1,pass
23287,1,True,2,2,4,1,1,pass
23289,1,False,1,0,1,1,1,pass
23290,2,True,1,1,2,1,1,pass
23291,2,True,106,0,106,1,1,pass
23292,1,True,0,0,0,1,1,fail
23293,1,True,106,0,106,1,1,fail
23294,1,True,1,1,2,1,1,fail
23295,2,True,3,3,6,1,1,pass
23296,1,False,4,2,6,1,1,pass
23298,1,True,3,3,6,1,1,pass
23299,2,True,3,3,6,1,1,pass
23300,2,True,1,1,2,1,1,pass
23301,1,True,3,3,6,1,1,pass
23302,1,True,1,1,2,1,1,pass
23303,2,True,119,0,119,3,2,pass
23304,1,True,11,0,11,1,1,pass
23305,1,True,2,2,4,1,1,pass
23306,1,True,106,0,106,1,1,pass
23308,2,True,1,2,3,1,1,pass
23309,1,True,1,2,3,1,1,pass
23310,2,True,198,7,205,3,2,pass
23311,1,True,77,77,154,1,1,pass
23312,1,True,106,0,106,1,1,fail
23316,1,False,4,1,5,1,1,pass
23317,2,True,1,1,2,1,1,pass
23318,1,True,1,1,2,1,1,pass
23319,1,False,9,9,18,1,1,pass
23320,2,False,64,0,64,2,2,pass
23322,1,False,4,2,6,1,1,pass
23323,1,False,62,0,62,2,2,pass
23324,1,False,6,6,12,1,1,pass
23325,1,False,13,17,30,3,1,fail
23326,2,True,150,0,150,1,1,pass
23327,1,False,1,1,2,1,1,pass
23329,2,True,1,1,2,1,1,pass
23330,1,True,1,1,2,1,1,pass
23331,2,True,4,1,5,1,1,pass
23332,1,True,4,1,5,1,1,pass
23333,2,True,1,1,2,1,1,pass
23334,1,True,1,1,2,1,1,fail
23335,1,False,45,0,45,2,1,pass
23337,1,False,2,2,4,1,1,pass
23339,2,False,48,24,72,3,1,pass
23341,2,True,1,1,2,1,1,pass
23342,2,True,47,23,70,2,1,pass
23343,1,False,3,3,6,2,2,pass
23344,1,False,1,1,2,1,1,fail
23345,1,False,1,1,2,1,1,fail
23346,2,False,18,0,18,1,1,fail
23348,2,False,10,9,19,6,4,fail
23350,1,False,1,1,2,1,1,fail
23351,2,False,1,1,2,1,1,fail
23354,2,True,1,1,2,1,1,fail
23355,1,True,1,1,2,1,1,fail
23356,2,False,3423,129,3552,73,7,fail
23357,2,True,1,1,2,1,1,fail
23358,1,True,1,1,2,1,1,fail
23359,1,False,3,0,3,1,1,pass
23360,1,False,18,0,18,1,1,pass
23361,1,False,4,0,4,1,1,pass
23362,1,True,106,0,106,1,1,pass
23363,1,True,1337930,1,1337931,6,2,pass
23364,2,True,4,3,7,2,1,pass
23365,1,True,1,1,2,1,1,pass
23367,1,True,46,22,68,1,1,pass
23368,2,True,150,0,150,1,1,pass
23369,1,True,4,3,7,2,1,pass
23370,1,True,1,1,2,1,1,pass
23371,2,True,1790,18,1808,22,5,fail
23372,1,True,27,27,54,1,1,pass
23375,1,True,4,2,6,2,2,fail
23376,2,True,151,3,154,3,3,pass
23377,2,True,1528,6,1534,15,3,pass
23378,2,True,111,9,120,4,4,pass
23381,1,True,1,1,2,1,1,pass
23382,1,False,4,0,4,1,1,pass
23383,1,True,106,0,106,1,1,pass
23384,1,False,8,2,10,2,1,pass
23386,1,False,17,0,17,1,1,pass
23388,1,True,21,5,26,2,2,pass
23389,2,True,3,0,3,1,1,pass
23390,2,True,1,1,2,1,1,pass
23391,2,True,536,1,537,3,1,pass
23392,1,True,1,1,2,1,1,fail
23393,1,True,2,0,2,1,1,pass
23394,1,True,534,1,535,3,1,fail
23395,2,True,2,1,3,1,1,pass
23396,2,True,1,1,2,1,1,pass
23397,1,True,2,1,3,1,1,pass
23398,1,True,150,0,150,1,1,pass
23399,1,True,1,1,2,1,1,pass
23400,1,True,106,0,106,1,1,pass
23401,1,True,1,0,1,1,1,fail
23402,1,True,854,54,908,10,2,fail
23404,2,False,244,18,262,3,2,pass
23408,2,True,244,18,262,3,2,pass
23409,1,False,31,1,32,2,2,pass
23411,1,False,1,1,2,1,1,pass
23412,1,True,1,1,2,1,1,pass
23420,1,False,1,1,2,1,1,pass
23421,1,False,1,1,2,1,1,pass
23430,2,True,52,12,64,5,2,pass
23431,2,True,109,3,112,2,2,pass
23432,1,True,2,2,4,1,1,fail
23433,1,True,107,1,108,2,2,pass
23434,1,False,3,1,4,1,1,pass
23435,1,False,4,0,4,1,1,fail
23436,1,False,6,6,12,1,1,fail
23437,2,False,119,1,120,3,3,fail
23439,1,True,220,5,225,5,1,fail
23441,2,True,119,1,120,3,3,pass
23442,1,True,1,1,2,1,1,pass
23445,1,False,5,2,7,1,1,pass
23446,2,True,106,0,106,1,1,pass
23447,1,True,106,0,106,1,1,fail
23448,1,False,3,3,6,1,1,pass
23449,1,False,3,1,4,1,1,pass
23450,1,True,1,1,2,1,1,pass
23451,1,False,1,1,2,1,1,pass
23452,2,False,120,1,121,3,3,pass
23454,1,True,1,1,2,1,1,fail
23455,1,True,3,0,3,1,1,fail
23456,1,True,3,4,7,1,1,pass
23459,2,True,120,1,121,3,3,pass
23460,1,False,3,0,3,1,1,pass
23461,1,True,106,0,106,1,1,pass
23464,1,False,22,1,23,2,1,pass
23466,2,True,1,1,2,1,1,pass
23467,1,True,1,1,2,1,1,pass
23468,2,True,107,1,108,2,2,pass
23469,1,True,106,0,106,1,1,pass
23474,1,False,1,1,2,1,1,pass
23475,2,False,1,1,2,1,1,pass
23477,2,True,1,1,2,1,1,pass
23478,1,True,1,1,2,1,1,pass
23479,1,False,7,0,7,1,1,pass
23480,1,True,5,6,11,2,2,pass
23482,1,False,2,2,4,1,1,pass
23483,1,True,11,10,21,3,2,pass
23484,1,False,2,2,4,1,1,pass
23486,2,False,155,115,270,7,2,pass
23488,2,True,155,115,270,7,2,fail
23489,1,False,3,4,7,1,1,fail
23493,2,True,1,1,2,1,1,pass
23494,1,False,17,0,17,1,1,pass
23495,1,True,1,1,2,1,1,pass
23496,1,True,32,23,55,1,1,pass
23498,1,True,9,2,11,3,2,fail
23499,1,True,5,8,13,2,2,pass
23500,1,False,1,1,2,1,1,pass
23501,1,True,27,5,32,4,2,fail
23502,1,True,1,15,16,1,1,fail
23503,1,True,5,0,5,1,1,pass
23504,1,True,2,0,2,1,1,pass
23505,1,True,3,0,3,1,1,pass
23506,1,True,1,3,4,1,1,pass
23509,1,True,118,84,202,7,2,pass
23510,2,True,1,1,2,1,1,pass
23512,1,True,1,1,2,1,1,pass
23513,2,True,26,0,26,3,2,pass
23514,2,False,313,8,321,14,5,pass
23517,1,True,3,0,3,1,1,pass
23520,2,False,273,1,274,3,2,pass
23522,2,True,106,0,106,1,1,pass
23523,2,True,4,38,42,1,1,pass
23524,2,True,167,1,168,2,2,pass
23525,1,True,106,0,106,1,1,pass
23526,1,True,4,38,42,1,1,pass
23527,1,True,106,0,106,1,1,pass
23528,1,True,61,1,62,1,1,pass
23529,1,False,3,2,5,2,1,pass
23532,1,False,1,1,2,1,1,pass
23533,1,False,3,1,4,1,1,pass
23535,2,True,159,12,171,5,4,pass
23536,1,True,1,1,2,1,1,fail
23537,1,True,3,3,6,1,1,fail
23538,1,False,2,15,17,2,1,pass
23539,1,True,106,0,106,1,1,pass
23541,1,True,0,1,1,1,1,fail
23543,1,False,17,0,17,1,1,pass
23545,1,False,4,5,9,1,1,pass
23546,1,False,1,0,1,1,1,pass
23548,1,False,1,2,3,2,2,pass
23549,2,True,1,1,2,1,1,pass
23550,1,True,1,1,2,1,1,fail
23551,1,False,0,1,1,1,1,pass
23552,1,False,42,40,82,18,4,pass
23553,1,False,2,2,4,1,1,pass
23554,1,False,37,10,47,1,1,pass
23555,1,False,4,0,4,1,1,pass
23556,1,False,2,0,2,1,1,pass
23557,1,False,0,1,1,1,1,pass
23558,2,True,2,2,4,2,1,pass
23559,2,True,108,2,110,3,2,pass
23560,1,False,12,3,15,1,1,pass
23561,1,True,2,2,4,2,1,pass
23562,1,True,1,1,2,1,1,pass
23563,1,True,106,0,106,1,1,pass
23564,1,True,1,1,2,1,1,pass
23567,1,False,36,0,36,2,2,pass
23568,1,False,2,2,4,1,1,pass
23569,1,False,1,1,2,1,1,pass
23570,1,False,8,1,9,2,2,pass
23571,2,False,13,8,21,2,2,pass
23573,2,False,1,0,1,1,1,pass
23575,2,False,154,7,161,7,5,pass
23577,1,False,2,1,3,1,1,pass
23578,1,False,36,0,36,2,1,pass
23579,1,False,4,0,4,1,1,pass
23581,2,False,109,1,110,3,3,pass
23583,2,True,107,1,108,2,2,pass
23584,1,True,106,0,106,1,1,fail
23585,1,True,1,1,2,1,1,pass
23586,1,False,2,0,2,1,1,pass
23587,1,False,4,1,5,1,1,fail
23588,1,False,2,2,4,1,1,fail
23589,1,False,1,1,2,1,1,fail
23590,2,False,54,19,73,7,5,fail
23592,1,False,31,18,49,5,3,fail
23593,2,True,23,1,24,2,2,fail
23594,1,True,1,1,2,1,1,fail
23595,1,False,2,2,4,1,1,fail
23596,1,False,1,1,2,1,1,fail
23597,1,False,1,0,1,1,1,pass
23598,1,True,1,1,2,1,1,pass
23599,1,True,1,1,2,1,1,pass
23600,1,True,22,0,22,1,1,pass
23601,2,False,39,18,57,2,1,pass
23603,1,False,19,0,19,1,1,pass
23604,2,False,2,2,4,1,1,pass
23606,1,False,2,2,4,1,1,fail
23607,1,False,1,1,2,1,1,fail
23609,1,False,109,184,293,1,1,pass
23610,1,False,184,109,293,1,1,pass
23611,2,True,3076612,48436,3125048,300,13,pass
23612,2,True,1,1,2,1,1,pass
23613,1,True,15,40,55,9,2,fail
23614,1,True,2,2,4,1,1,fail
23615,1,True,2,2,4,1,1,fail
23616,2,True,7,6,13,4,3,fail
23618,1,False,5,3,8,1,1,pass
23619,1,True,3,3,6,1,1,pass
23620,1,True,1,2,3,2,1,fail
23623,2,True,159,84,243,25,5,fail
23625,1,True,94,24,118,5,2,fail
23626,1,False,5,0,5,1,1,pass
23627,1,True,65,60,125,21,5,fail
23628,1,False,5,0,5,1,1,pass
23629,1,False,1,1,2,1,1,pass
23630,2,True,0,0,0,0,0,pass
23631,2,True,490,188,678,32,3,pass
23633,1,True,6,7,13,1,1,pass
23634,1,True,41,38,79,16,2,fail
23635,1,True,15,21,36,14,1,fail
23636,1,True,0,8,8,3,2,fail
23637,1,True,158,31,189,6,2,fail
23639,1,True,136,84,220,6,1,fail
23642,1,True,47,46,93,2,2,fail
23643,1,True,9,10,19,1,1,fail
23644,1,True,0,0,0,1,1,fail
23646,2,True,141,109,250,15,3,fail
23650,1,True,22,13,35,6,1,pass
23651,1,True,23,11,34,1,1,pass
23653,2,True,0,2,2,1,1,pass
23656,2,True,99,96,195,18,3,pass
23658,1,True,87,70,157,6,2,pass
23659,1,True,12,26,38,12,1,pass
23660,1,True,2,1,3,1,1,pass
23661,1,True,1,1,2,1,1,pass
23663,1,True,1,1,2,1,1,pass
23665,2,True,119,58,177,6,3,pass
23666,1,True,1,1,2,1,1,fail
23667,2,True,51,8,59,2,1,pass
23669,1,True,51,8,59,2,1,fail
23670,1,True,46,14,60,2,1,fail
23673,1,True,2,2,4,1,1,pass
23675,1,True,19,14,33,1,1,pass
23676,1,True,1,1,2,1,1,pass
23677,1,True,4,4,8,4,1,pass
23678,1,True,5,3,8,1,1,pass
23680,1,True,1,0,1,1,1,pass
23681,1,True,11,6,17,4,2,pass
23682,2,True,25,2,27,4,3,pass
23685,1,True,1,0,1,1,1,fail
23687,1,True,23,1,24,2,1,fail
23688,2,True,5,2,7,3,2,fail
23690,2,True,2,1,3,1,1,fail
23693,2,True,7252,7019,14271,27,6,fail
23695,1,True,1,1,2,1,1,pass
23698,2,True,4,2,6,1,1,fail
23701,2,True,6736,6669,13405,9,2,fail
23703,1,True,317,314,631,1,1,fail
23704,1,True,5037,5033,10070,1,1,fail
23705,1,True,8,5,13,2,1,fail
23706,1,True,43,2,45,1,1,fail
23708,1,True,806,803,1609,1,1,fail
23709,1,True,303,300,603,1,1,fail
23710,1,True,40,40,80,1,1,pass
23711,1,True,213,210,423,1,1,pass
23712,2,True,408,315,723,16,4,pass
23714,2,True,143,11,154,7,3,pass
23721,1,True,10,2,12,2,1,pass
23723,1,True,1,1,2,1,1,pass
23724,1,True,1,1,2,1,1,pass
23726,2,True,109,2,111,2,2,pass
23727,1,True,1,1,2,1,1,pass
23728,1,True,5041,0,5041,2,1,pass
23729,1,True,811,0,811,2,1,pass
23730,1,True,310,310,620,1,1,pass
23731,2,True,106,0,106,1,1,pass
23732,1,True,0,0,0,1,1,pass
23734,1,True,106,0,106,1,1,pass
23736,2,True,9,16,25,2,1,pass
23738,2,True,375,175,550,13,6,pass
23740,1,True,2,0,2,1,1,pass
23743,1,True,2,2,4,1,1,pass
23744,1,True,4,4,8,1,1,pass
23745,1,True,7,7,14,1,1,pass
23746,1,True,316,107,423,1,1,pass
23753,1,True,14,3,17,1,1,pass
23754,1,True,0,28,28,1,1,pass
23755,1,True,28,0,28,1,1,pass
23756,1,True,23,5,28,4,2,pass
23757,2,True,39,11,50,3,2,pass
23761,1,True,11,9,20,1,1,pass
23762,1,True,2,2,4,1,1,pass
23764,1,True,26,0,26,1,1,pass
23765,1,True,1,1,2,1,1,pass
23766,1,True,1,2,3,1,1,pass
23768,2,True,1409,97,1506,36,6,fail
23771,2,True,106,0,106,1,1,pass
23772,2,True,10,10,20,2,2,fail
23773,1,True,9,9,18,1,1,fail
23774,1,True,1,1,2,1,1,fail
23775,2,True,25,4,29,3,1,fail
23784,1,True,4,0,4,1,1,fail
23786,2,True,619,26,645,11,4,fail
23789,1,True,34,18,52,6,3,pass
23790,1,True,106,0,106,1,1,pass
23791,1,True,568,0,568,4,2,pass
23792,1,True,14,6,20,2,2,pass
23794,1,True,1,0,1,1,1,pass
23801,2,True,29,16,45,3,2,pass
23803,1,True,23,10,33,1,1,pass
23807,2,True,12,23,35,1,1,pass
23809,1,True,12,23,35,1,1,pass
23810,1,True,4,0,4,1,1,fail
23811,2,True,65,73,138,14,5,pass
23812,1,True,1,1,2,1,1,pass
23820,1,True,4,5,9,1,1,pass
23821,2,True,89,79,168,15,4,pass
23823,1,True,0,0,0,3,1,pass
23825,2,True,51,9,60,3,2,pass
23831,1,True,6,4,10,1,1,pass
23837,1,True,682,514,1196,6,2,pass
23840,1,True,0,2,2,1,1,pass
23841,2,True,18,152,170,10,2,pass
23846,2,True,4,1,5,1,1,fail
23850,2,True,488,271,759,26,6,fail
23852,1,True,1,1,2,1,1,fail
23853,1,True,2,0,2,1,1,fail
23854,1,True,1,0,1,1,1,fail
23855,1,True,17,4,21,2,1,fail
23857,1,True,260,159,419,5,2,fail
23859,2,True,2,6,8,2,2,fail
23863,1,True,2,6,8,2,2,fail
23867,2,True,686,2,688,9,2,fail
23869,2,True,686,2,688,9,2,fail
23870,1,True,22,25,47,1,1,fail
23871,2,True,1,2,3,1,1,pass
23873,1,True,26,19,45,1,1,pass
23874,2,True,317,191,508,10,2,pass
23875,1,True,1,2,3,1,1,fail
23876,1,True,1,1,2,1,1,pass
23877,1,True,1,1,2,1,1,fail
23878,1,True,0,2,2,1,1,fail
23879,1,True,39,60,99,15,1,pass
23880,1,True,2,2,4,1,1,fail
23881,1,True,3,4,7,1,1,fail
23882,1,True,12,2,14,1,1,fail
23883,1,True,2,1,3,1,1,fail
23884,1,True,6,1,7,1,1,fail
23885,1,True,5,5,10,1,1,fail
23887,1,True,1,1,2,1,1,fail
23890,1,True,1,1,2,1,1,fail
23891,1,True,3,3,6,1,1,fail
23892,2,True,21739,18775,40514,300,13,fail
23893,2,True,779,373,1152,22,4,pass
23894,1,True,39,20,59,1,1,pass
23896,2,True,682,343,1025,34,7,fail
23900,1,True,20,6,26,2,1,pass
23901,1,True,0,4,4,1,1,pass
23902,2,True,27,16,43,2,1,pass
23904,2,True,392,69,461,15,5,pass
23906,1,True,2,401,403,2,2,pass
23907,1,True,558,2,560,4,3,pass
23910,1,True,95,1,96,1,1,pass
23912,2,True,45,3,48,2,2,pass
23917,1,True,6,3,9,1,1,pass
23919,1,True,23,21,44,2,2,pass
23920,1,True,1,1,2,1,1,pass
23921,1,True,2,4,6,1,1,fail
23923,1,True,26,11,37,7,2,pass
23924,2,True,285,257,542,9,3,fail
23930,1,True,249,1,250,4,3,pass
23934,1,True,48,6,54,3,2,pass
23942,2,True,168,156,324,9,4,pass
23948,2,True,168,156,324,9,4,pass
23949,1,True,16,0,16,3,2,pass
23951,1,True,2,1,3,1,1,pass
23955,1,True,1,1,2,1,1,pass
23957,1,True,2,2,4,2,2,pass
23962,2,True,2032,3275,5307,73,4,pass
23963,1,True,2,3,5,1,1,fail
23964,2,True,3079,3661,6740,111,8,fail
23965,2,True,2005,3334,5339,71,4,pass
23966,1,True,233,261,494,14,2,pass
23968,1,True,59,67,126,1,1,pass
23969,1,True,195,230,425,8,1,fail
23973,1,True,0,144,144,2,2,pass
23974,1,True,4,2,6,1,1,pass
23975,1,True,384,237,621,7,2,fail
23979,1,True,52,51,103,3,1,pass
23985,1,True,20,0,20,1,1,pass
23987,2,True,1661,3284,4945,78,8,pass
23988,1,True,2,2,4,1,1,pass
23989,1,True,11,11,22,7,1,pass
23990,1,True,10,5,15,2,1,fail
23991,2,True,1576,1402,2978,42,5,pass
23996,1,True,118,8,126,3,2,pass
23998,1,True,157,0,157,1,1,pass
24003,1,True,129,59,188,3,1,pass
24004,1,True,1,1,2,1,1,pass
24005,2,True,38,1852,1890,24,3,pass
24006,1,True,3,3,6,3,2,pass
24007,1,True,31,3,34,4,3,pass
24008,1,True,4,4,8,1,1,pass
24009,1,True,71,90,161,2,1,pass
24011,1,True,4,5,9,1,1,pass
24012,1,True,65,16,81,4,2,pass
24013,1,True,103,87,190,1,1,pass
24016,1,True,10,12,22,1,1,pass
24020,1,True,41,33,74,2,1,pass
24021,1,True,7,0,7,1,1,pass
24022,1,True,55,3,58,3,2,pass
24024,1,True,0,22,22,1,1,pass
24035,1,True,74,36,110,2,1,pass
24040,1,True,0,1,1,1,1,pass
24043,1,True,1,0,1,1,1,pass
24045,1,True,5,0,5,5,1,pass
24047,1,True,5,5,10,1,1,pass
24048,1,True,35,112,147,11,3,pass
24049,2,True,24,23,47,4,3,pass
24050,2,True,2983,482,3465,86,8,pass
24051,1,True,44,12,56,1,1,pass
24053,2,True,16,3,19,2,1,pass
24054,1,True,16,3,19,2,1,pass
24055,2,True,33,9,42,3,2,pass
24056,2,True,28,4,32,2,2,pass
24057,1,True,27,3,30,2,2,pass
24058,1,True,1,1,2,1,1,pass
24059,1,True,10,3,13,2,2,fail
24060,1,True,2,2,4,1,1,fail
24061,1,True,10,19,29,1,1,fail
24063,1,True,1,1,2,1,1,fail
24065,2,True,1,2,3,1,1,fail
24066,2,True,1326,259,1585,31,5,fail
24067,1,True,96,78,174,1,1,fail
24070,2,True,1326,259,1585,31,5,fail
24072,1,True,2,0,2,2,1,fail
24073,1,True,31,0,31,1,1,fail
24074,1,True,78,0,78,2,1,fail
24076,1,True,1,4,5,1,1,fail
24077,1,True,26,0,26,1,1,fail
24083,1,True,14,0,14,2,2,fail
24084,1,True,3,3,6,1,1,fail
24085,1,False,15,16,31,1,1,pass
24086,1,True,15,16,31,1,1,fail
24090,2,True,184,25,209,10,1,fail
24091,1,True,961,5,966,10,1,fail
24092,1,True,1,1,2,1,1,fail
24093,1,True,1,1,2,1,1,fail
24094,1,True,32,36,68,4,1,fail
24096,1,False,4,4,8,1,1,pass
24097,1,False,1,1,2,1,1,pass
24099,1,False,51,22,73,1,1,pass
24103,2,True,866,1141,2007,11,4,pass
24106,1,True,4,4,8,2,2,pass
24116,2,True,37,2,39,3,1,pass
24119,1,True,36,0,36,2,1,pass
24121,2,True,692,692,1384,1,1,pass
24123,1,True,692,692,1384,1,1,pass
24124,2,True,1103,0,1103,1,1,pass
24127,1,True,1103,0,1103,1,1,pass
24128,2,True,59161,12030,71191,300,20,pass
24129,1,False,33,0,33,1,1,pass
24130,2,True,843,0,843,7,1,pass
24131,2,True,116,0,116,4,2,pass
24132,2,True,85,70,155,10,4,pass
24133,2,True,166,14,180,4,4,pass
24134,2,True,16,3,19,2,1,pass
24135,2,True,12,0,12,1,1,pass
24136,1,True,12,0,12,1,1,pass
24137,1,True,6,3,9,1,1,pass
24138,1,True,19,0,19,1,1,pass
24142,2,True,5,5,10,1,1,pass
24143,2,True,106,0,106,1,1,pass
24144,1,True,106,0,106,1,1,pass
24145,1,True,5,5,10,1,1,fail
24146,1,True,16,3,19,2,1,pass
24147,1,True,23,0,23,1,1,pass
24149,1,True,116,0,116,4,2,pass
24150,1,True,23,1,24,2,2,pass
24151,2,True,40,22,62,4,3,pass
24155,1,True,1,1,2,1,1,pass
24163,1,True,11,14,25,1,1,pass
24164,2,True,167,16,183,4,4,pass
24165,1,True,34,22,56,3,3,pass
24167,1,True,1,1,2,1,1,pass
24169,1,True,3,4,7,1,1,fail
24170,1,True,2,2,4,1,1,fail
24171,1,True,17,20,37,1,1,fail
24172,1,True,19,7,26,1,1,pass
24173,1,True,19,7,26,1,1,pass
24174,1,True,146,9,155,3,3,pass
24175,1,True,39,8,47,2,2,pass
24176,2,True,108,2,110,2,1,pass
24182,1,True,106,0,106,1,1,pass
24183,1,True,2,2,4,1,1,pass
24186,1,True,112,0,112,2,2,pass
24187,2,True,123,190,313,6,4,pass
24188,1,True,6,15,21,1,1,fail
24190,1,True,7,0,7,1,1,pass
24192,1,True,16,16,32,1,1,fail
24193,1,True,16,63,79,1,1,fail
24194,1,True,53,62,115,2,2,fail
24195,2,True,108,2,110,2,2,pass
24200,1,True,106,0,106,1,1,pass
24201,2,True,2119,453,2572,84,8,pass
24203,1,False,2,0,2,1,1,pass
24204,1,False,106,0,106,1,1,pass
24205,1,False,106,0,106,1,1,pass
24206,1,False,1,1,2,1,1,pass
24207,1,False,4,4,8,1,1,pass
24208,1,False,106,0,106,1,1,pass
24209,1,False,1,1,2,1,1,pass
24210,2,True,241,1,242,5,2,pass
24211,1,True,6,0,6,1,1,fail
24212,1,True,9,2,11,1,1,pass
24214,1,True,24,4,28,1,1,pass
24216,2,True,71,86,157,6,4,pass
24226,2,True,64,64,128,2,2,pass
24227,1,True,7,22,29,4,2,pass
24228,1,True,19,3,22,1,1,pass
24230,2,True,1,1,2,1,1,pass
24231,1,True,63,63,126,1,1,pass
24233,1,True,33,0,33,2,2,pass
24234,1,True,17,0,17,1,1,pass
24235,2,True,33,42,75,7,3,pass
24236,2,True,3,3,6,2,2,pass
24237,1,True,3,3,6,2,2,pass
24239,1,True,24,24,48,1,1,fail
24241,1,True,4,0,4,1,1,fail
24242,1,True,2,2,4,1,1,fail
24243,1,True,1,1,2,1,1,fail
24249,1,True,0,1,1,1,1,fail
24251,2,True,95,28,123,3,3,pass
24252,1,True,1,1,2,1,1,fail
24253,1,True,1,1,2,1,1,fail
24255,1,True,13,16,29,1,1,fail
24256,2,True,2318,778,3096,78,6,fail
24260,2,True,21,6,27,4,1,pass
24261,2,True,12,7,19,1,1,pass
24262,2,True,107,0,107,2,1,pass
24264,1,True,21,6,27,4,1,pass
24265,1,True,6,8,14,1,1,pass
24266,1,True,14,7,21,1,1,pass
24267,1,True,34,0,34,1,1,pass
24268,1,True,1,0,1,1,1,pass
24269,2,True,106,0,106,1,1,pass
24270,1,True,239,0,239,3,1,pass
24272,1,True,10,0,10,1,1,pass
24273,1,True,32,9,41,2,1,pass
24274,1,True,44,1,45,2,2,pass
24275,1,True,31,1,32,2,1,pass
24276,1,True,50,6,56,4,1,pass
24278,1,True,12,12,24,2,1,pass
24279,1,True,9,1,10,1,1,pass
24283,1,True,106,0,106,1,1,pass
24284,2,True,302,7,309,9,3,pass
24285,1,True,1,0,1,1,1,pass
24286,1,True,106,0,106,1,1,pass
24287,1,True,1,1,2,1,1,pass
24288,1,True,25,6,31,1,1,fail
24290,1,True,21,2,23,3,2,pass
24292,1,True,16,0,16,1,1,pass
24293,1,True,0,1,1,1,1,pass
24295,1,True,2,2,4,1,1,pass
24297,2,True,126,1,127,3,1,pass
24298,2,True,4,5,9,1,1,pass
24299,2,True,1,1,2,1,1,fail
24301,1,True,1,1,2,1,1,pass
24302,1,True,2,4,6,1,1,fail
24303,1,True,126,1,127,3,1,fail
24304,1,True,2,2,4,1,1,fail
24307,1,True,2,2,4,1,1,fail
24308,1,True,1,1,2,1,1,pass
24310,2,True,1142,175,1317,23,4,pass
24311,2,True,106,159,265,27,3,pass
24312,1,True,54,54,108,17,1,pass
24313,2,True,7,4,11,1,1,pass
24314,1,True,4,17,21,1,1,pass
24315,1,True,1,1,2,1,1,pass
24317,1,True,13,0,13,1,1,pass
24322,2,True,87,22,109,11,3,fail
24323,2,True,34,19,53,7,2,fail
24324,2,True,12,12,24,2,1,pass
24325,1,True,12,12,24,2,1,pass
24326,1,True,3,2,5,1,1,pass
24327,2,True,84,20,104,10,3,fail
24329,1,True,1,1,2,1,1,fail
24331,1,True,2,0,2,1,1,fail
24333,1,True,2,1,3,1,1,fail
24336,2,True,53,4,57,5,3,fail
24341,1,True,16,23,39,10,2,fail
24342,1,True,15,19,34,2,1,fail
24345,1,True,5,3,8,1,1,fail
24347,2,True,56,6,62,3,1,fail
24348,2,True,1,1,2,1,1,fail
24350,2,True,8,1,9,1,1,fail
24352,1,True,8,1,9,1,1,fail
24353,1,True,7,6,13,1,1,fail
24354,1,True,21,15,36,1,1,fail
24355,1,True,50,0,50,1,1,fail
24356,2,True,333,97,430,21,3,fail
24357,1,True,1,1,2,1,1,fail
24359,1,True,7,4,11,1,1,pass
24361,2,True,724,403,1127,20,5,pass
24362,1,True,289,0,289,5,3,fail
24370,2,True,29,8,37,1,1,pass
24374,1,True,3,1,4,1,1,fail
24375,1,True,0,1,1,1,1,pass
24376,1,True,30,8,38,1,1,pass
24377,2,True,724,403,1127,20,5,fail
24378,1,True,8,0,8,3,2,pass
24382,1,True,20,2,22,2,2,pass
24383,2,True,79,3,82,3,2,pass
24384,2,True,121,10,131,8,3,pass
24385,2,True,24,15,39,3,2,pass
24387,1,True,3,2,5,1,1,pass
24388,2,True,215,31,246,5,1,pass
24389,1,True,68,0,68,1,1,fail
24392,1,True,1,0,1,1,1,pass
24393,1,True,1,1,2,1,1,fail
24394,1,True,2,0,2,1,1,fail
24402,1,True,4,4,8,1,1,fail
24403,1,True,1,1,2,1,1,fail
24404,1,True,4,4,8,1,1,fail
24405,1,True,2,1,3,1,1,fail
24406,1,True,22,24,46,1,1,fail
24407,1,True,2,2,4,1,1,fail
24408,1,True,50,0,50,1,1,fail
24411,1,True,2,36,38,1,1,fail
24413,2,True,187,51,238,7,4,fail
24414,1,True,2,2,4,1,1,fail
24415,2,True,152,39,191,4,3,pass
24416,1,True,7,0,7,1,1,fail
24418,1,True,5,5,10,1,1,fail
24419,1,True,10,0,10,1,1,fail
24420,1,True,51,142,193,1,1,pass
24422,1,True,0,17,17,1,1,pass
24423,1,True,20,2,22,2,2,pass
24424,1,True,14,0,14,1,1,pass
24425,1,True,216,13,229,1,1,pass
24426,1,True,8,7,15,1,1,pass
24427,1,True,84,43,127,2,1,pass
24428,1,True,23,1,24,3,2,pass
24429,1,True,43,0,43,2,1,pass
24430,1,True,2,1,3,1,1,pass
24431,1,True,3,2,5,1,1,pass
24435,1,True,0,1,1,1,1,pass
24436,1,True,24,2,26,1,1,pass
24437,1,True,4,4,8,1,1,pass
24438,1,True,2,1,3,1,1,pass
24440,1,True,2,2,4,1,1,pass
24441,2,True,3,3,6,1,1,pass
24442,1,False,1,0,1,1,1,pass
24443,1,True,13,11,24,1,1,pass
24447,1,True,3,3,6,1,1,pass
24448,1,True,3,3,6,1,1,pass
24450,1,True,3,0,3,1,1,fail
24454,2,True,106,0,106,1,1,pass
24455,1,True,16,15,31,1,1,pass
24456,1,True,24,15,39,3,2,pass
24457,1,True,106,0,106,1,1,pass
24458,1,False,7,0,7,1,1,pass
24459,2,True,49,9,58,3,1,pass
24460,2,True,9,9,18,4,1,pass
24462,1,True,17,0,17,1,1,pass
24465,2,True,10426,10360,20786,300,18,pass
24468,1,True,1,1,2,1,1,fail
24472,1,True,1,1,2,1,1,pass
24473,1,True,1,1,2,1,1,pass
24474,1,True,1,1,2,1,1,pass
24475,1,True,3,2,5,1,1,pass
24476,1,True,2,2,4,1,1,pass
24477,1,True,5,4,9,1,1,pass
24478,1,True,1,3,4,1,1,pass
24479,1,True,11,0,11,1,1,pass
24480,1,True,2,2,4,1,1,pass
24481,2,True,3,3,6,1,1,pass
24483,1,True,3,3,6,1,1,fail
24484,1,True,1,1,2,1,1,fail
24485,1,True,1,1,2,1,1,fail
24488,2,True,8933,9422,18355,263,13,fail
24492,2,True,8933,9422,18355,263,13,pass
24493,2,True,3,3,6,1,1,pass
24494,1,True,3,3,6,3,1,pass
24495,1,True,3,3,6,1,1,pass
24496,1,True,2,2,4,1,1,pass
24497,1,True,6,2,8,2,2,pass
24498,1,True,53,0,53,1,1,pass
24501,1,True,32,13,45,1,1,pass
24503,1,True,5,2,7,2,1,pass
24504,1,True,1,1,2,1,1,pass
24505,1,True,1,1,2,1,1,fail
24506,1,True,1,0,1,1,1,fail
24510,1,True,393,381,774,6,2,pass
24511,1,True,10,4,14,3,2,pass
24512,1,True,7,12,19,1,1,fail
24514,1,True,0,1,1,1,1,pass
24515,2,True,25,11,36,4,1,fail
24519,1,True,1,1,2,1,1,pass
24520,1,True,1,1,2,1,1,pass
24521,1,True,1,1,2,1,1,pass
24522,1,True,3,2,5,1,1,pass
24523,1,True,623,0,623,1,1,pass
24533,1,True,4,4,8,1,1,fail
24534,1,True,6,8,14,1,1,fail
24536,1,True,41,8,49,1,1,fail
24539,1,True,3,3,6,1,1,pass
24540,1,True,1,1,2,1,1,pass
24541,1,True,16,8,24,1,1,pass
24542,1,True,10,7,17,1,1,pass
24543,1,True,1,1,2,1,1,pass
24544,2,True,54,324,378,4,2,pass
24546,1,True,30,322,352,2,1,fail
24547,2,True,109,8,117,7,2,fail
24549,1,True,1,1,2,1,1,pass
24550,2,True,8,3,11,2,1,pass
24553,1,True,3,1,4,1,1,pass
24554,1,True,1,303,304,2,2,pass
24555,1,True,5,2,7,1,1,pass
24557,2,True,3,0,3,1,1,pass
24558,1,True,3,3,6,1,1,pass
24559,1,True,1,1,2,1,1,pass
24560,1,True,1,1,2,1,1,pass
24562,1,True,2,2,4,1,1,pass
24563,1,True,1,1,2,1,1,pass
24568,2,True,4,4,8,3,1,pass
24569,1,True,2,2,4,1,1,pass
24572,2,True,240,1,241,7,1,pass
24573,2,True,95,72,167,3,2,pass
24574,1,True,1,0,1,1,1,pass
24575,1,True,1,1,2,1,1,pass
24576,1,True,1,1,2,1,1,fail
24577,1,True,3,2,5,1,1,pass
24580,1,True,2,2,4,2,2,pass
24581,2,True,287,196,483,21,6,pass
24582,2,True,199,194,393,15,5,pass
24583,1,True,1,0,1,1,1,fail
24585,1,True,43,0,43,2,1,fail
24586,1,True,4,0,4,1,1,fail
24587,1,True,38,0,38,2,1,fail
24590,1,True,1,1,2,1,1,fail
24591,1,True,6,4,10,1,1,fail
24592,2,True,14,5,19,1,1,pass
24593,1,True,3,0,3,1,1,pass
24594,2,True,263,2,265,8,1,pass
24597,1,True,0,1,1,1,1,fail
24598,2,True,60,11,71,4,4,fail
24600,1,True,1,1,2,1,1,fail
24601,1,True,1,1,2,1,1,fail
24602,1,True,0,1,1,1,1,fail
24603,1,True,0,1,1,1,1,fail
24604,1,True,1,0,1,1,1,fail
24605,1,True,1,1,2,1,1,fail
24609,1,True,3,0,3,1,1,fail
24610,1,True,3,0,3,1,1,fail
24611,1,True,5,2,7,1,1,fail
24612,1,True,1,0,1,1,1,fail
24615,1,True,14,5,19,1,1,pass
24616,1,True,20,5,25,1,1,fail
24617,1,True,25,25,50,1,1,fail
24618,2,True,107,89,196,6,2,fail
24620,2,True,1,1,2,1,1,pass
24626,1,True,2,0,2,1,1,fail
24627,2,True,102,85,187,6,2,fail
24628,1,True,0,1,1,1,1,fail
24630,1,True,1,0,1,1,1,fail
24638,2,True,8,4,12,1,1,pass
24639,2,True,3,1,4,1,1,pass
24640,1,True,1,1,2,1,1,pass
24641,1,True,9,5,14,1,1,pass
24642,1,True,1,1,2,1,1,pass
24643,1,True,3,1,4,1,1,pass
24647,1,True,19,0,19,2,1,pass
24648,1,True,27,13,40,1,1,fail
24653,2,True,2,2,4,1,1,pass
24654,1,True,1,1,2,1,1,pass
24655,1,True,0,0,0,1,1,fail
24661,1,True,2,39,41,2,1,pass
24663,1,True,2,2,4,1,1,pass
24664,1,True,2,0,2,1,1,pass
24665,1,True,3,2,5,1,1,fail
24667,2,True,2,0,2,1,1,pass
24668,1,True,1,1,2,1,1,pass
24670,1,True,3,1,4,1,1,fail
24676,1,True,1,1,2,1,1,fail
24678,1,True,1,1,2,1,1,fail
24679,1,True,2,2,4,1,1,fail
24683,2,True,43,25,68,7,2,fail
24689,1,True,40,20,60,4,1,pass
24690,1,True,3,5,8,3,2,pass
24697,1,True,1,1,2,1,1,pass
24698,1,True,5,3,8,1,1,fail
24699,1,True,11,2,13,2,2,fail
24700,1,True,1,0,1,1,1,fail
24701,1,True,10,0,10,1,1,fail
24702,1,True,1,1,2,1,1,fail
24703,1,True,1,1,2,1,1,fail
24704,1,True,1,0,1,1,1,fail
24705,1,True,3,3,6,2,2,fail
24706,1,True,1,0,1,1,1,fail
24707,1,True,1,0,1,1,1,fail
24708,1,True,1,1,2,1,1,fail
24709,1,True,52,0,52,1,1,fail
24710,2,True,82,114,196,2,2,pass
24715,1,False,2,2,4,1,1,pass
24717,2,False,1,0,1,1,1,pass
24720,2,False,138,90,228,14,4,fail
24721,2,False,1,1,2,1,1,fail
24727,2,True,1,1,2,1,1,pass
24730,1,False,1,1,2,1,1,pass
24731,1,True,1,1,2,1,1,pass
24732,1,True,1,1,2,1,1,fail
24733,1,True,4,0,4,1,1,fail
24734,1,True,8,7,15,1,1,fail
24735,1,True,1,1,2,1,1,fail
24736,1,True,18,0,18,2,1,fail
24737,2,True,43967,458,44425,108,11,pass
24738,2,True,31,1,32,2,2,pass
24739,1,False,0,1,1,1,1,pass
24742,1,False,1,0,1,1,1,pass
24745,2,False,15,21,36,3,2,pass
24746,1,False,14,16,30,3,2,pass
24751,1,False,1,1,2,1,1,pass
24752,1,False,2,2,4,1,1,pass
24753,1,False,1,1,2,1,1,pass
24754,1,False,3,3,6,2,2,fail
24755,2,True,42,1,43,2,2,fail
24756,1,False,1,1,2,1,1,fail
24757,1,True,1,1,2,1,1,fail
24758,2,True,120,0,120,4,2,pass
24759,1,False,1,3,4,2,2,fail
24760,1,False,0,1,1,1,1,pass
24761,1,False,3,2,5,2,2,fail
24762,1,False,6,5,11,1,1,pass
24766,2,False,207,29,236,4,2,fail
24768,1,True,9,2,11,1,1,pass
24774,1,True,113,0,113,4,2,pass
24777,1,False,3,1,4,1,1,fail
24781,2,False,41879,16,41895,15,2,pass
24784,1,True,22,28,50,1,1,fail
24788,1,False,1,1,2,1,1,pass
24789,1,False,10,12,22,1,1,fail
24790,1,True,48,1,49,2,2,pass
24791,1,True,13,4,17,2,1,pass
24792,1,False,2,2,4,1,1,fail
24793,2,True,41867,2,41869,13,1,pass
24794,1,False,1,1,2,1,1,pass
24796,2,True,23,5,28,1,1,pass
24797,1,False,1,1,2,1,1,pass
24802,1,False,8,2,10,1,1,pass
24803,2,True,340,85,425,25,5,pass
24804,1,False,2,0,2,1,1,pass
24805,1,True,31,1,32,2,2,pass
24807,1,False,19,18,37,1,1,pass
24809,1,False,2,1,3,1,1,pass
24810,2,False,75,6,81,6,2,fail
24812,1,False,4,1,5,1,1,fail
24813,1,False,4,1,5,1,1,fail
24815,2,False,60,19,79,4,3,fail
24817,1,True,1,0,1,1,1,pass
24818,2,False,10,7,17,4,2,fail
24824,1,False,4,1,5,1,1,fail
24825,2,False,6,6,12,3,2,fail
24827,1,True,30,7,37,2,1,fail
24831,1,False,13,0,13,1,1,pass
24834,1,False,6,6,12,3,2,fail
24835,1,True,23,5,28,1,1,pass
24836,1,False,1,1,2,1,1,fail
24840,1,False,1,1,2,1,1,fail
24841,1,False,12,11,23,1,1,fail
24844,1,True,1,1,2,1,1,fail
24845,2,False,140,12,152,9,3,pass
24849,1,False,6,6,12,6,2,pass
24850,2,True,134,6,140,3,1,pass
24858,2,False,3,3,6,1,1,pass
24860,1,False,2,2,4,1,1,fail
24863,1,False,7,7,14,1,1,fail
24864,1,False,1,1,2,1,1,pass
24865,1,True,134,6,140,3,1,pass
24866,1,False,6,8,14,2,1,pass
24870,1,False,1,1,2,1,1,fail
24871,1,False,29,13,42,2,1,fail
24874,2,False,2,3,5,1,1,pass
24876,1,False,2,3,5,1,1,pass
24877,2,False,327,8,335,18,4,pass
24882,2,False,392,28,420,24,5,pass
24884,1,False,29,0,29,1,1,pass
24890,1,False,230,0,230,11,1,pass
24891,1,False,7,2,9,1,1,pass
24894,1,False,13,12,25,1,1,pass
24898,1,False,0,1,1,1,1,fail
24901,1,False,100,0,100,2,1,fail
24905,1,False,24,17,41,1,1,fail
24911,2,False,255,77,332,7,4,fail
24913,1,False,2,2,4,2,2,fail
24914,1,False,9,8,17,1,1,fail
24915,1,False,0,48,48,1,1,fail
24916,2,False,492,31,523,13,5,fail
24921,2,False,448,28,476,10,4,fail
24923,1,False,41,29,70,2,1,fail
24925,2,True,1,1,2,1,1,pass
24926,1,True,1,1,2,1,1,pass
24927,1,False,53,49,102,3,1,fail
24932,2,True,1,1,2,1,1,pass
24933,1,True,1,1,2,1,1,pass
24934,1,False,1,1,2,1,1,fail
24935,1,False,11,4,15,1,1,fail
24942,1,False,8,1,9,1,1,pass
24943,1,False,1,1,2,1,1,pass
24944,1,False,11,4,15,2,2,pass
24947,1,False,143,660,803,15,3,pass
24949,1,False,1,1,2,1,1,pass
24954,2,False,45,22,67,2,1,fail
24956,1,False,45,22,67,2,1,fail
24957,1,False,39,52,91,3,1,fail
24962,1,False,2,2,4,1,1,fail
24963,2,False,5,4,9,1,1,fail
24971,1,False,5,4,9,1,1,fail
24972,1,False,12,12,24,1,1,fail
24978,2,True,1,1,2,1,1,fail
24979,1,True,1,1,2,1,1,fail
24980,1,False,2,2,4,1,1,fail
24983,2,False,11,5,16,6,4,fail
24986,2,False,11,5,16,6,4,fail
24988,1,False,3,0,3,3,3,fail
24990,1,False,8,4,12,2,1,fail
24993,1,False,14,14,28,2,2,fail
24994,1,True,3,1,4,1,1,fail
24995,1,True,366,0,366,1,1,fail
24996,2,True,38309,24755,63064,278,13,fail
24997,2,True,13,13,26,10,2,pass
24998,1,True,177,27,204,4,1,fail
25000,1,True,13,13,26,10,2,pass
25001,1,False,29,11,40,1,1,fail
25003,2,True,2,1,3,1,1,pass
25004,1,False,3,0,3,2,1,fail
25009,1,True,2,1,3,1,1,pass
25010,1,False,6,2,8,1,1,pass
25015,1,False,73,11,84,2,2,fail
25017,1,False,1,1,2,1,1,pass
25023,2,False,12,1,13,2,1,pass
25026,1,False,12,1,13,2,1,pass
25030,1,False,3,4,7,1,1,pass
25050,1,False,1,1,2,1,1,pass
25052,1,False,1,1,2,1,1,pass
25077,1,False,1,1,2,1,1,pass
25078,1,False,8,1,9,1,1,pass
25080,1,False,16,5,21,1,1,pass
25082,1,False,11,2,13,1,1,fail
25084,2,False,106,9,115,10,2,pass
25092,1,False,5,3,8,1,1,pass
25094,1,False,21,0,21,1,1,pass
25101,1,False,2,1,3,1,1,pass
25102,1,False,2,2,4,2,2,pass
25103,1,False,2,2,4,2,2,pass
25104,1,False,1,1,2,1,1,fail
25107,1,False,31,0,31,1,1,fail
25108,1,False,1,1,2,1,1,fail
25109,1,False,3,3,6,1,1,pass
25110,2,False,19,3,22,3,2,pass
25112,1,False,1,0,1,1,1,pass
25113,1,False,15,0,15,1,1,pass
25114,1,False,1,1,2,1,1,pass
25115,1,False,3,3,6,1,1,pass
25116,1,False,2,1,3,1,1,pass
25117,1,False,1,1,2,1,1,fail
25120,1,False,22,0,22,2,2,pass
25124,1,False,2,0,2,1,1,pass
25125,2,True,25,0,25,1,1,pass
25127,2,False,20,1,21,2,1,pass
25129,2,True,20,1,21,2,1,pass
25136,2,False,22077,16677,38754,13,3,pass
25142,2,True,1,1,2,1,1,pass
25150,1,True,1,1,2,1,1,pass
25151,2,True,1,1,2,1,1,pass
25152,1,True,1,1,2,1,1,pass
25153,2,True,1,1,2,1,1,pass
25154,1,True,1,1,2,1,1,pass
25155,2,True,50,8,58,4,1,pass
25156,1,True,1,1,2,1,1,pass
25157,1,True,1,1,2,1,1,pass
25158,2,True,1,1,2,1,1,pass
25159,1,True,1,1,2,1,1,pass
25160,1,True,1,1,2,1,1,pass
25163,1,True,2,0,2,1,1,pass
25170,1,True,20,12,32,1,1,pass
25173,2,True,2,2,4,2,2,pass
25174,1,False,1,0,1,1,1,pass
25175,2,True,1,0,1,1,1,pass
25176,1,True,1,0,1,1,1,pass
25177,1,True,2,2,4,2,2,pass
25178,1,True,12,3,15,1,1,fail
25180,1,True,25,0,25,1,1,pass
25181,1,True,5,5,10,1,1,pass
25182,1,True,33,0,33,1,1,pass
25183,1,True,3,1,4,1,1,pass
25184,1,True,15,1,16,3,1,fail
25186,1,False,1,0,1,1,1,pass
25187,2,True,25,1,26,2,1,pass
25188,2,True,37430,24699,62129,270,13,pass
25189,1,True,23,0,23,1,1,fail
25192,1,True,11,45,56,1,1,pass
25193,1,True,1,1,2,1,1,pass
25194,1,True,65,65,130,1,1,pass
25195,1,True,106,0,106,1,1,pass
25196,1,True,1,1,2,1,1,pass
25198,2,True,1,1,2,1,1,pass
25199,2,True,1,1,2,1,1,pass
25200,1,True,1,1,2,1,1,pass
25201,1,True,1,1,2,1,1,pass
25202,2,True,21964,16663,38627,1,1,pass
25203,2,True,4,4,8,1,1,pass
25204,2,True,1,1,2,1,1,pass
25205,2,True,4,4,8,1,1,pass
25206,1,True,4,4,8,1,1,pass
25207,2,True,1,0,1,1,1,pass
25208,2,True,75,1,76,3,2,pass
25209,2,True,1,1,2,1,1,pass
25210,2,True,1,1,2,1,1,pass
25211,2,True,1,1,2,1,1,pass
25212,2,True,1,0,1,1,1,pass
25213,1,True,1,0,1,1,1,pass
25214,1,True,44,0,44,2,1,pass
25216,1,True,1,1,2,1,1,pass
25218,1,True,130,0,130,3,1,pass
25225,1,True,686,0,686,4,1,pass
25226,1,True,4,4,8,1,1,pass
25227,1,True,21964,16663,38627,1,1,pass
25229,1,False,2,2,4,1,1,pass
25230,1,True,1,1,2,1,1,fail
25231,1,True,1,1,2,1,1,fail
25232,2,True,1,1,2,1,1,pass
25233,1,True,1,1,2,1,1,pass
25234,1,False,143,0,143,1,1,pass
25235,1,False,2,2,4,1,1,pass
25236,1,False,4,4,8,3,2,pass
25237,1,False,7,4,11,4,2,pass
25239,1,False,1,0,1,1,1,pass
25240,1,False,1,1,2,1,1,pass
25241,1,False,1,1,2,1,1,pass
25243,1,False,2,2,4,1,1,pass
25244,1,True,2,2,4,1,1,pass
25245,2,False,11,5,16,3,3,pass
25246,1,False,3,1,4,1,1,pass
25249,1,False,1,1,2,1,1,pass
25251,1,False,7,9,16,1,1,fail
25255,1,False,128,11,139,3,2,fail
25256,1,False,51,24,75,1,1,fail
25257,1,False,14,0,14,2,2,fail
25261,1,False,38,0,38,1,1,fail
25262,2,False,36,19,55,1,1,fail
25264,1,False,2,1,3,1,1,fail
25265,1,False,35,19,54,1,1,fail
25271,1,False,1,2,3,1,1,fail
25273,1,False,2,2,4,2,2,fail
25274,1,False,2,2,4,1,1,pass
25275,2,False,37,6,43,2,1,pass
25279,2,False,472,177,649,45,5,pass
25282,1,False,11,8,19,6,1,pass
25283,1,False,196,117,313,16,1,pass
25284,2,False,183,68,251,23,4,fail
25286,1,False,1,1,2,1,1,fail
25287,1,False,2,2,4,1,1,fail
25288,2,False,47,3,50,1,1,fail
25291,1,False,3,3,6,1,1,fail
25292,1,False,3,1,4,1,1,fail
25293,1,False,3,2,5,1,1,fail
25294,1,False,6,0,6,1,1,fail
25295,1,False,35,0,35,1,1,fail
25303,1,False,0,2,2,1,1,fail
25304,2,True,29,8,37,2,1,fail
25305,1,False,2,1,3,1,1,fail
25306,1,False,16,16,32,1,1,fail
25307,1,False,6,6,12,1,1,fail
25308,1,False,1,0,1,1,1,fail
25309,2,False,14,3,17,3,2,fail
25311,1,False,8,0,8,1,1,pass
25312,1,False,2,0,2,1,1,pass
25313,1,False,4,3,7,1,1,pass
25314,2,False,93,11,104,7,3,pass
25318,1,False,8,7,15,1,1,pass
25319,1,False,79,0,79,2,1,pass
25324,1,False,1,0,1,1,1,pass
25326,1,False,1,1,2,1,1,pass
25327,1,False,90,57,147,1,1,pass
25328,1,False,40,1,41,1,1,pass
25329,1,False,2,0,2,1,1,pass
25330,1,False,13,4,17,2,1,fail
25331,1,False,2,2,4,1,1,fail
25332,1,False,1,0,1,1,1,fail
25333,1,False,1,1,2,1,1,fail
25335,1,False,4,4,8,1,1,fail
25338,1,False,1,1,2,1,1,fail
25340,1,False,13,9,22,1,1,fail
25344,1,False,216,109,325,3,1,fail
25345,2,False,196,76,272,17,2,fail
25347,2,False,332,166,498,23,3,fail
25349,1,False,48,24,72,12,1,fail
25350,1,False,117,29,146,1,1,fail
25352,1,False,2,2,4,2,1,fail
25356,1,False,0,1,1,1,1,fail
25357,2,False,2276,325,2601,28,4,fail
25359,1,False,101,88,189,2,1,fail
25360,1,False,13,0,13,1,1,fail
25361,1,False,23,2,25,2,1,fail
25363,2,False,2110,217,2327,19,4,fail
25368,1,False,1767,2,1769,2,1,fail
25371,1,False,16,0,16,1,1,pass
25373,1,False,14,6,20,1,1,pass
25376,1,False,5,3,8,1,1,fail
25384,1,False,2,2,4,2,1,pass
25387,1,False,2,2,4,2,2,pass
25388,1,False,5,6,11,1,1,fail
25389,1,False,1,0,1,1,1,fail
25390,1,False,19,17,36,1,1,fail
25391,1,False,104,28,132,3,2,fail
25392,1,False,1,2,3,1,1,pass
25393,1,False,2,2,4,2,2,fail
25394,1,False,9,3,12,1,1,fail
25395,1,False,29,0,29,1,1,fail
25397,1,False,25,0,25,1,1,pass
25400,1,False,39,0,39,1,1,pass
25402,2,False,1,11,12,2,1,pass
25404,1,False,1,1,2,1,1,pass
25405,1,False,5,1,6,1,1,fail
25406,1,False,0,0,0,1,1,pass
25407,1,False,0,0,0,1,1,pass
25408,1,False,0,5,5,1,1,pass
25409,1,False,0,5,5,1,1,pass
25411,1,False,0,5,5,1,1,fail
25413,1,False,2,0,2,1,1,pass
25414,1,False,2,0,2,1,1,pass
25415,1,False,9,0,9,1,1,fail
25416,1,False,9,0,9,1,1,fail
25418,2,True,55,33,88,2,2,fail
25419,1,False,119,0,119,2,1,pass
25424,1,True,2,31,33,1,1,pass
25427,2,False,16,5,21,4,3,pass
25429,1,False,2,2,4,1,1,pass
25430,1,False,2,2,4,1,1,pass
25431,1,False,12,1,13,2,2,pass
25432,1,False,11,0,11,1,1,pass
25434,1,False,0,15,15,3,1,pass
25436,1,False,16,4,20,3,2,pass
25438,1,False,8,4,12,1,1,pass
25440,1,False,1,1,2,1,1,pass
25441,1,False,4,1,5,1,1,pass
25442,1,False,15,3,18,6,3,pass
25443,1,False,1,1,2,1,1,fail
25444,1,False,3,2,5,1,1,fail
25447,1,False,13,10,23,1,1,fail
25448,1,False,45,0,45,1,1,fail
25452,2,False,359,209,568,12,3,fail
25454,1,False,6,4,10,1,1,fail
25468,1,True,29,8,37,2,1,fail
25469,1,False,7,2,9,2,1,fail
25470,1,False,2,2,4,2,2,fail
25472,2,False,8,8,16,1,1,pass
25475,2,False,33,5,38,2,1,fail
25476,2,False,364,237,601,21,5,fail
25480,2,False,120,22,142,5,3,fail
25486,1,False,47,0,47,1,1,fail
25489,1,False,65,16,81,2,2,fail
25490,2,False,7,12,19,3,2,fail
25492,1,False,1,1,2,1,1,fail
25493,2,True,6,11,17,2,1,fail
25494,2,False,6,3,9,2,2,fail
25495,1,False,1,1,2,1,1,pass
25496,1,False,5,2,7,1,1,pass
25500,2,False,34,18,52,2,1,pass
25502,1,True,6,11,17,2,1,pass
25504,1,False,34,18,52,2,1,pass
25505,2,False,407,411,818,37,2,pass
25512,1,False,12,3,15,1,1,fail
25513,1,False,374,408,782,34,1,fail
25518,1,False,5,4,9,1,1,fail
25519,2,False,5,5,10,3,1,fail
25520,1,False,4,4,8,1,1,fail
25526,2,False,88,63,151,8,2,fail
25528,1,False,2,2,4,2,1,pass
25530,1,False,6,6,12,1,1,pass
25531,1,False,6,5,11,1,1,pass
25533,1,False,1,0,1,1,1,pass
25534,1,False,5,6,11,1,1,fail
25535,1,False,8,4,12,1,1,pass
25537,1,False,2,0,2,2,1,fail
25538,1,False,1,1,2,1,1,fail
25539,1,False,6,5,11,2,2,fail
25540,1,False,5,4,9,1,1,fail
25541,2,False,207,59,266,17,4,fail
25544,1,False,14,1,15,2,2,pass
25545,1,False,7,4,11,2,1,pass
25553,1,False,4,4,8,1,1,fail
25559,2,False,1,0,1,1,1,pass
25561,1,False,1,0,1,1,1,pass
25562,1,False,21,12,33,1,1,pass
25563,2,False,27,20,47,6,2,pass
25565,1,False,27,20,47,6,2,fail
25566,1,False,2,2,4,1,1,fail
25567,1,False,2,1,3,1,1,fail
25568,1,False,3,3,6,1,1,fail
25569,1,False,3,3,6,1,1,fail
25570,1,False,28,18,46,4,1,fail
25573,1,False,173,4,177,2,2,fail
25575,1,False,13,144,157,6,1,fail
25577,1,False,142,56,198,7,3,fail
25578,2,False,151,59,210,20,3,fail
25580,1,False,126,43,169,14,1,fail
25587,2,False,782,714,1496,58,6,fail
25590,1,False,59,21,80,13,2,fail
25602,2,False,720,271,991,40,6,pass
25605,1,False,49,50,99,4,1,pass
25606,1,False,38,5,43,1,1,pass
25608,1,False,26,0,26,1,1,pass
25610,1,False,16,16,32,5,1,pass
25612,1,False,132,93,225,5,2,pass
25616,2,False,209,67,276,17,3,pass
25625,1,False,8,3,11,1,1,pass
25628,1,False,115,4,119,1,1,pass
25632,2,False,6,4,10,3,2,pass
25636,2,False,107,63,170,9,3,pass
25640,2,False,856,444,1300,40,4,pass
25643,1,False,3,3,6,1,1,pass
25644,1,False,105,10,115,2,1,pass
25645,1,False,54,102,156,5,2,pass
25649,1,False,79,30,109,7,2,pass
25660,2,False,2363,1654,4017,52,6,pass
25673,1,False,11,0,11,3,1,pass
25680,1,False,121,113,234,1,1,pass
25682,1,False,22,7,29,1,1,pass
25684,1,False,56,37,93,1,1,pass
25685,1,False,8,213,221,4,2,pass
25688,1,False,6,0,6,1,1,pass
25689,1,False,60,65,125,1,1,pass
25692,1,False,29,5,34,2,1,pass
25697,1,False,53,79,132,8,2,pass
25699,1,False,137,92,229,5,2,pass
25702,1,False,73,0,73,1,1,pass
25726,2,False,76,14,90,2,2,pass
25731,1,False,43,20,63,2,2,pass
25732,2,True,1,1,2,1,1,pass
25733,2,True,1,1,2,1,1,pass
25734,1,True,1,1,2,1,1,fail
25735,1,True,1,1,2,1,1,pass
25739,1,False,2,12,14,2,1,pass
25741,1,False,1,1,2,1,1,pass
25742,1,False,1,2,3,1,1,fail
25744,1,False,7,7,14,3,2,fail
25745,1,False,2,5,7,4,1,fail
25751,2,True,2,1,3,1,1,pass
25752,2,True,0,5,5,1,1,pass
25753,2,True,10,0,10,1,1,pass
25754,2,True,1,1,2,1,1,pass
25759,1,False,129,21,150,1,1,fail
25767,1,True,1,1,2,1,1,pass
25769,1,False,2,4,6,1,1,fail
25775,1,False,33,27,60,3,2,fail
25778,2,False,206,348,554,17,4,fail
25782,1,False,87,29,116,6,4,fail
25786,1,False,0,1,1,1,1,fail
25788,1,False,9,9,18,1,1,fail
25804,1,False,106,75,181,4,2,fail
25809,2,False,3792,2768,6560,68,8,fail
25818,1,False,166,69,235,2,2,fail
25820,1,False,99,62,161,2,2,fail
25824,1,False,10,0,10,1,1,fail
25830,1,False,64,220,284,6,1,fail
25836,1,False,2,1,3,1,1,fail
25840,1,False,198,136,334,2,2,fail
25842,1,False,35,8,43,3,2,fail
25843,1,False,16,24,40,3,2,fail
25844,1,False,97,12,109,2,2,fail
25845,1,False,9,16,25,1,1,fail
25846,1,False,0,24,24,1,1,fail
25847,1,False,207,0,207,1,1,fail
25850,2,False,165,56,221,13,4,fail
25854,1,False,1,1,2,1,1,pass
25864,1,False,12,13,25,1,1,pass
25865,1,False,6,7,13,1,1,pass
25870,1,False,4,4,8,2,1,pass
25871,1,False,165,111,276,1,1,pass
25880,1,False,113,186,299,2,2,pass
25881,1,True,10,0,10,1,1,pass
25882,1,True,0,5,5,1,1,pass
25886,1,False,24,24,48,3,1,pass
25892,1,False,185,112,297,3,1,fail
25893,2,True,4,4,8,1,1,pass
25894,1,False,375,303,678,2,2,fail
25898,1,False,2,2,4,1,1,pass
25900,1,False,137,60,197,2,2,pass
25902,1,False,127,127,254,15,1,pass
25903,1,False,65,3,68,1,1,pass
25906,1,True,4,4,8,1,1,pass
25907,1,False,81,86,167,1,1,pass
25910,2,False,103,79,182,8,5,pass
25915,1,False,20,11,31,2,1,pass
25916,1,False,17,2,19,2,1,pass
25919,1,False,41,51,92,1,1,pass
25920,1,False,41,51,92,1,1,pass
25929,1,True,1,2,3,1,1,pass
25930,1,True,3,1,4,1,1,pass
25931,1,False,207,12,219,8,4,pass
25936,1,False,8,4,12,2,2,pass
25938,1,False,1,1,2,1,1,pass
25940,1,False,5,3,8,2,1,pass
25942,2,False,402,25,427,23,7,pass
25945,1,False,13,2,15,1,1,pass
25960,2,False,2,0,2,1,1,pass
25962,1,False,2,0,2,2,2,pass
25963,1,False,2,0,2,1,1,pass
25965,2,False,1024,110,1134,16,4,fail
25967,1,False,54,2,56,1,1,pass
25968,1,False,8,0,8,1,1,pass
25969,1,False,1,1,2,1,1,pass
25970,1,False,2,2,4,1,1,pass
25971,1,False,24,5,29,1,1,pass
25973,1,False,233,1,234,3,3,pass
25978,1,False,1,1,2,1,1,pass
25979,1,False,227,0,227,2,2,pass
25981,1,False,10,3,13,2,1,pass
25982,1,False,385,0,385,4,1,pass
25983,1,False,0,1,1,1,1,pass
25986,1,False,3,2,5,2,2,pass
25988,1,False,942,388,1330,5,2,pass
25990,1,False,14,12,26,1,1,fail
25994,1,False,232,0,232,2,2,pass
25999,1,False,49,8,57,1,1,pass
26000,1,False,0,1,1,1,1,pass
26001,1,False,10,12,22,1,1,fail
26002,1,False,76,0,76,1,1,fail
26006,1,False,19,0,19,1,1,pass
26007,1,False,19,20,39,4,1,pass
26009,1,False,22,20,42,7,2,pass
26011,1,False,12,19,31,1,1,pass
26012,1,False,6,3,9,1,1,pass
26016,1,False,6,4,10,1,1,pass
26021,1,False,1,0,1,1,1,fail
26022,1,False,0,1,1,1,1,fail
26023,1,False,5,0,5,1,1,fail
26024,1,False,1,1,2,1,1,fail
26025,1,False,0,4,4,1,1,fail
26026,2,True,5,0,5,1,1,fail
26027,2,True,0,4,4,1,1,fail
26028,2,False,75,0,75,3,2,fail
26029,2,False,74,0,74,3,2,fail
26031,1,False,5,0,5,1,1,pass
26036,1,False,405,287,692,4,2,fail
26037,1,True,0,4,4,1,1,pass
26038,1,False,19,8,27,1,1,pass
26047,1,False,70,0,70,2,1,pass
26049,1,False,88,0,88,3,1,pass
26050,1,False,21,30,51,1,1,pass
26059,1,False,5,1,6,1,1,pass
26060,1,False,1,1,2,1,1,fail
26061,1,False,11,0,11,1,1,fail
26064,1,False,27,182,209,1,1,fail
26065,1,False,0,177,177,4,3,fail
26066,1,False,1,2,3,1,1,fail
26068,1,False,26,15,41,2,1,fail
26072,1,False,134,0,134,1,1,pass
26074,1,False,0,519,519,6,1,pass
26075,1,False,4,9,13,25,1,pass
26091,1,False,0,0,0,80,2,fail
26092,1,False,25,28,53,5,1,pass
26094,1,False,8,10,18,2,1,pass
26096,1,False,2,0,2,1,1,fail
26097,1,False,4,2,6,1,1,fail
26126,1,False,0,76,76,1,1,fail
26128,1,False,2,2,4,1,1,fail
26141,1,False,1,1,2,1,1,fail
26145,1,True,5,0,5,1,1,pass
26149,1,False,3,1,4,1,1,fail
26151,1,False,19,68,87,1,1,fail
26152,1,False,167,291,458,11,1,fail
26159,2,False,1679,376,2055,62,9,pass
26160,1,False,3,2,5,1,1,pass
26164,1,False,5,3,8,1,1,fail
26165,1,False,3,3,6,1,1,fail
26166,1,False,33,30,63,4,2,fail
26167,1,False,207,307,514,4,2,fail
26179,1,False,2,42,44,1,1,pass
26188,2,True,2,2,4,1,1,pass
26189,1,False,295,0,295,2,1,pass
26190,1,True,2,2,4,1,1,pass
26191,1,False,3,2,5,1,1,pass
26192,1,False,34,5,39,6,1,pass
26193,1,False,2,0,2,1,1,pass
26194,2,False,0,0,0,0,0,pass
26197,1,False,1,0,1,1,1,pass
26198,1,False,4,3,7,1,1,pass
26199,1,False,7,6,13,1,1,pass
26200,2,True,84,4,88,7,2,pass
26201,1,True,2,1,3,1,1,fail
26202,1,True,4,1,5,1,1,fail
26203,1,True,1,1,2,1,1,fail
26204,1,True,1,1,2,1,1,fail
26205,1,True,1,1,2,1,1,pass
26206,1,True,1,1,2,1,1,pass
26209,2,True,3,1,4,1,1,pass
26210,1,True,3,1,4,1,1,fail
26211,2,False,522,30,552,16,4,pass
26213,1,True,1,1,2,1,1,pass
26214,1,False,1,0,1,1,1,pass
26215,1,False,1,6,7,1,1,pass
26218,1,False,1,1,2,1,1,pass
26219,1,False,2,2,4,1,1,pass
26220,1,False,2,2,4,1,1,pass
26221,1,False,0,20,20,1,1,pass
26222,1,False,1,0,1,1,1,pass
26223,2,True,497,4,501,12,2,pass
26224,1,True,1,1,2,1,1,fail
26225,1,True,1,1,2,1,1,fail
26226,1,True,1,1,2,1,1,fail
26227,1,True,1,1,2,1,1,fail
26228,1,True,1,1,2,1,1,pass
26230,1,True,3,3,6,1,1,pass
26234,1,False,1,1,2,1,1,pass
26235,1,False,2,0,2,1,1,pass
26236,1,False,10,1,11,1,1,pass
26238,1,False,1,1,2,1,1,pass
26241,1,False,16,0,16,2,2,pass
26242,1,False,4,5,9,1,1,pass
26245,1,False,19,11,30,2,1,fail
26246,1,False,24,37,61,1,1,pass
26251,1,False,106,35,141,1,1,fail
26257,2,True,3,3,6,1,1,pass
26258,1,True,3,3,6,1,1,pass
26259,1,False,3,0,3,2,1,pass
26260,1,False,3,1,4,1,1,fail
26261,1,False,5,3,8,1,1,fail
26262,1,False,1,1,2,1,1,fail
26263,1,False,2,1,3,1,1,fail
26264,1,False,2,0,2,1,1,pass
26265,2,False,19,6,25,3,1,fail
26267,1,False,0,6,6,1,1,fail
26268,1,False,19,0,19,1,1,fail
26272,1,False,1,1,2,1,1,pass
26273,1,False,20,0,20,1,1,fail
26275,2,False,13,2,15,2,2,fail
26279,1,False,11,0,11,1,1,pass
26281,1,False,1,1,2,1,1,pass
26282,2,False,57,34,91,13,3,pass
26284,1,False,0,6,6,1,1,fail
26285,1,False,19,0,19,1,1,fail
26289,1,False,1,1,2,1,1,pass
26290,1,False,20,0,20,1,1,fail
26292,2,False,13,2,15,2,2,fail
26296,1,False,11,0,11,1,1,pass
26298,1,False,1,1,2,1,1,pass
26299,2,False,57,34,91,13,3,pass
26301,1,False,6,2,8,2,1,pass
26302,2,True,6,2,8,3,2,pass
26303,1,True,1,1,2,1,1,fail
26304,1,True,1,1,2,1,1,pass
26305,1,True,6,2,8,3,2,pass
26306,1,False,1,0,1,1,1,pass
26307,2,True,1,0,1,1,1,pass
26308,2,True,16,22,38,5,1,pass
26309,1,True,1,1,2,1,1,pass
26310,1,True,1,1,2,1,1,pass
26323,1,False,14,8,22,1,1,pass
26324,1,False,12,3,15,1,1,pass
26325,1,False,2,0,2,1,1,pass
26326,1,False,3,1,4,1,1,pass
26327,2,False,492,155,647,25,6,pass
26329,1,False,11,2,13,2,2,pass
26330,1,False,2,5,7,1,1,pass
26332,1,False,2,1,3,1,1,pass
26333,1,False,16,0,16,1,1,pass
26336,2,False,5,4,9,1,1,pass
26337,1,False,5,4,9,1,1,pass
26338,2,False,543,201,744,27,6,pass
26339,1,False,1,1,2,1,1,pass
26340,1,False,6,5,11,1,1,pass
26341,1,False,1,1,2,1,1,pass
26342,1,False,2,0,2,1,1,pass
26343,1,False,1,1,2,1,1,pass
26344,1,False,1,1,2,1,1,pass
26345,1,False,1,1,2,1,1,fail
26346,1,False,5,3,8,1,1,pass
26347,1,False,1,2,3,1,1,fail
26349,1,False,2,1,3,1,1,fail
26353,1,False,1,0,1,1,1,fail
26354,1,False,1,1,2,1,1,pass
26355,1,False,1,1,2,1,1,pass
26356,2,False,396,114,510,12,4,pass
26357,1,False,29,0,29,1,1,pass
26372,1,False,4,0,4,1,1,pass
26373,1,False,1,1,2,1,1,pass
26374,1,False,14,17,31,1,1,pass
26375,1,False,24,19,43,1,1,pass
26376,1,False,13,6,19,1,1,pass
26377,1,False,6,3,9,1,1,pass
26378,1,False,2,1,3,1,1,pass
26379,1,False,9,0,9,1,1,pass
26380,1,False,16,6,22,2,1,pass
26383,2,False,885,762,1647,48,2,pass
26384,1,False,0,0,0,1,1,pass
26392,1,False,1,1,2,1,1,fail
26393,1,False,3,1,4,1,1,fail
26394,1,False,249,228,477,15,2,fail
26395,1,False,3,4,7,1,1,fail
26396,1,False,0,4,4,2,1,fail
26404,2,False,149,45,194,16,7,fail
26409,1,False,3,2,5,1,1,pass
26410,2,False,146,43,189,15,7,pass
26411,2,True,7,1,8,1,1,pass
26412,1,True,7,1,8,1,1,pass
26413,2,True,1,1,2,1,1,pass
26414,1,True,1,1,2,1,1,pass
26415,1,False,11,11,22,2,1,pass
26417,2,True,1,1,2,1,1,pass
26418,1,True,1,1,2,1,1,fail
26419,1,False,12,2,14,1,1,pass
26422,1,False,33,24,57,1,1,pass
26423,1,False,18,18,36,1,1,pass
26424,1,False,61,4,65,1,1,pass
26425,1,False,2,0,2,1,1,pass
26429,1,False,2,0,2,1,1,pass
26430,1,False,2,2,4,1,1,pass
26431,1,False,1,0,1,1,1,pass
26432,1,False,1,1,2,1,1,fail
26434,1,False,3,1,4,1,1,pass
26436,1,False,3,1,4,1,1,pass
26437,1,False,1,1,2,1,1,fail
26438,1,False,2,2,4,2,2,fail
26439,2,False,1,4,5,3,1,fail
26440,1,False,1,1,2,1,1,fail
26442,1,False,1,2,3,2,1,fail
26444,2,False,512,749,1261,16,3,fail
26445,2,False,248,16,264,8,2,fail
26446,2,False,482,742,1224,8,2,fail
26449,1,False,14,0,14,1,1,pass
26450,2,True,482,742,1224,8,2,fail
26451,1,False,4,0,4,2,1,fail
26452,2,False,333,36,369,16,4,fail
26456,2,True,4,4,8,3,2,pass
26457,1,False,1,0,1,1,1,pass
26458,1,False,0,1,1,1,1,pass
26459,1,False,90,13,103,1,1,pass
26460,1,False,91,0,91,2,1,pass
26464,2,False,242,45,287,18,6,pass
26465,2,False,147,2,149,4,2,pass
26466,1,True,106,0,106,1,1,pass
26467,1,False,14,0,14,1,1,pass
26470,1,True,376,742,1118,7,1,pass
26471,2,True,1,1,2,1,1,pass
26472,1,True,1,1,2,1,1,pass
26473,1,True,1,1,2,1,1,pass
26474,1,True,2,2,4,1,1,pass
26476,1,False,7,7,14,1,1,pass
26478,1,False,1,0,1,1,1,pass
26479,1,False,4,2,6,1,1,pass
26480,2,True,149,18,167,2,1,pass
26481,1,False,28,28,56,2,1,pass
26483,1,False,5,5,10,4,1,pass
26485,1,False,1,1,2,1,1,pass
26486,1,True,111,0,111,1,1,fail
26487,1,True,18,17,35,1,1,fail
26488,1,False,3,9,12,1,1,fail
26494,1,True,1,1,2,1,1,pass
26496,1,False,1,2,3,2,2,pass
26497,1,False,3,0,3,1,1,pass
26498,2,True,1,1,2,1,1,pass
26499,1,True,1,1,2,1,1,pass
26500,1,False,3,3,6,1,1,pass
26501,2,True,5,3,8,1,1,fail
26502,1,True,5,3,8,1,1,fail
26503,2,True,17,1,18,2,2,fail
26506,2,False,8,3,11,5,3,pass
26507,1,False,1,1,2,1,1,pass
26509,2,True,1,1,2,1,1,pass
26510,1,True,1,1,2,1,1,pass
26511,1,True,17,1,18,2,2,pass
26512,1,False,1,1,2,1,1,pass
26513,1,False,1,1,2,1,1,pass
26514,1,False,146,1,147,3,1,pass
26516,2,False,25,11,36,7,4,pass
26517,1,False,2,0,2,1,1,pass
26518,1,False,2,0,2,1,1,pass
26520,1,False,2,1,3,1,1,pass
26521,1,False,1,1,2,1,1,pass
26522,1,False,1,1,2,1,1,fail
26523,2,False,106,23,129,4,3,fail
26525,1,False,2,2,4,1,1,fail
26526,2,False,104,21,125,3,2,fail
26527,1,False,32,1,33,2,1,fail
26528,2,False,0,0,0,0,0,fail
26530,1,False,0,12,12,1,1,pass
26531,1,False,2,1,3,1,1,pass
26532,1,False,2,3,5,1,1,pass
26533,1,False,73,9,82,2,2,pass
26534,2,False,213,14,227,13,4,pass
26538,1,False,2,0,2,1,1,fail
26540,1,False,169,0,169,2,2,fail
26542,1,False,0,1,1,1,1,pass
26543,1,False,9,6,15,1,1,fail
26545,1,False,2,2,4,1,1,fail
26546,1,False,2,2,4,2,1,fail
26552,1,False,12,0,12,1,1,pass
26554,1,False,14,4,18,2,2,fail
26558,1,False,4,4,8,1,1,pass
26560,2,True,8,1,9,1,1,pass
26561,1,True,8,1,9,1,1,pass
26562,1,False,1,1,2,1,1,fail
26563,1,False,2,2,4,1,1,fail
26564,1,False,2,2,4,1,1,pass
26565,2,False,401,2,403,9,2,pass
26566,2,True,22005,909568,931573,261,47,pass
26570,1,False,113,0,113,1,1,pass
26572,2,True,1,1,2,1,1,pass
26573,1,True,1,1,2,1,1,pass
26575,1,False,129,2,131,3,1,fail
26577,1,False,0,391,391,2,1,pass
26578,2,False,7,40,47,12,2,pass
26579,2,False,171,7,178,8,3,pass
26580,2,True,0,4,4,2,1,pass
26581,2,True,4,28,32,9,2,pass
26582,1,False,1,1,2,1,1,pass
26584,2,True,0,4,4,1,1,pass
26585,1,True,0,4,4,1,1,pass
26586,2,True,3,8,11,1,1,pass
26587,1,True,1,1,2,1,1,pass
26588,1,True,2,7,9,1,1,pass
26589,1,True,4,28,32,9,2,pass
26590,1,False,1,1,2,1,1,pass
26591,1,False,1,1,2,1,1,pass
26592,1,False,1,1,2,1,1,pass
26593,1,False,1,1,2,1,1,pass
26594,1,False,2,2,4,1,1,pass
26595,1,False,3,5,8,1,1,pass
26596,1,False,1,1,2,1,1,pass
26597,1,False,5,1,6,1,1,pass
26598,1,False,38,1,39,2,2,pass
26600,1,False,12,1,13,1,1,pass
26605,1,False,1,1,2,1,1,pass
26606,1,False,166,1,167,3,1,pass
26612,2,False,20193,908979,929172,232,47,pass
26613,1,False,6,3,9,1,1,pass
26614,1,False,2,0,2,1,1,pass
26615,1,False,0,5,5,1,1,pass
26616,1,False,1,1,2,1,1,fail
26618,1,False,2,2,4,1,1,pass
26619,1,False,9,6,15,1,1,pass
26620,1,False,4,4,8,1,1,pass
26621,2,False,22,1,23,4,3,pass
26623,1,False,5,0,5,1,1,pass
26624,1,False,1,0,1,1,1,pass
26626,1,False,12,0,12,1,1,pass
26627,1,False,3,1,4,1,1,pass
26628,1,True,0,4,4,2,1,pass
26629,1,False,5,1,6,1,1,pass
26630,2,False,2,1,3,1,1,pass
26634,1,False,2,1,3,1,1,pass
26635,1,False,1,0,1,2,1,pass
26636,2,False,0,1,1,1,1,pass
26639,1,False,0,1,1,1,1,pass
26641,1,False,1,0,1,1,1,pass
26642,1,False,1,1,2,1,1,pass
26644,1,False,0,0,0,1,1,pass
26645,1,False,2,2,4,1,1,pass
26647,1,False,4,1,5,1,1,pass
26648,1,False,60,34,94,1,1,pass
26649,1,False,6,2,8,2,1,pass
26650,1,False,8,8,16,1,1,pass
26651,1,False,0,1,1,1,1,pass
26652,1,False,0,6,6,1,1,pass
26654,1,False,2,2,4,1,1,pass
26655,2,False,33,0,33,2,1,pass
26657,1,False,19,0,19,1,1,pass
26658,1,False,14,0,14,1,1,pass
26660,1,False,111,0,111,2,2,pass
26664,1,False,0,1,1,1,1,pass
26665,1,False,81,49,130,8,1,pass
26667,1,False,3,3,6,1,1,pass
26673,1,False,11,8,19,2,1,pass
26674,1,False,33,59,92,1,1,pass
26675,2,False,59,33,92,1,1,pass
26676,1,False,1,1,2,1,1,pass
26677,1,False,59,33,92,1,1,pass
26678,2,False,388,95,483,19,5,pass
26679,1,False,8,2,10,1,1,pass
26681,1,False,25,2,27,2,1,pass
26684,1,False,5,5,10,1,1,pass
26685,1,False,12,7,19,1,1,pass
26686,1,False,0,26,26,2,2,pass
26687,2,False,51677,913680,965357,300,45,pass
26689,1,False,1,0,1,1,1,pass
26692,1,False,2,2,4,1,1,fail
26695,1,False,1,1,2,1,1,pass
26696,1,False,1,1,2,1,1,fail
26697,1,False,2,14,16,2,1,fail
26699,1,False,738,0,738,1,1,fail
26703,2,True,14,1,15,2,1,fail
26705,2,True,18,0,18,3,3,pass
26706,1,False,1,1,2,1,1,pass
26710,1,False,1,1,2,1,1,pass
26711,1,False,7,7,14,1,1,pass
26713,1,False,8,1,9,1,1,pass
26714,1,False,1,1,2,1,1,pass
26723,2,False,4,4,8,1,1,pass
26726,1,False,3,4,7,1,1,pass
26729,1,False,5,4,9,1,1,pass
26730,1,False,4,4,8,1,1,pass
26731,1,False,3,3,6,1,1,fail
26733,1,False,2,1,3,1,1,fail
26736,1,False,1,0,1,1,1,pass
26745,1,False,6,0,6,1,1,pass
26747,1,False,1,1,2,1,1,pass
26751,1,False,23,27,50,1,1,pass
26775,1,False,0,16,16,1,1,pass
26776,2,False,16,0,16,1,1,fail
26777,1,False,16,0,16,1,1,pass
26778,1,False,0,16,16,1,1,pass
26779,1,False,15,0,15,1,1,fail
26780,1,False,0,1,1,1,1,fail
26781,1,False,14,0,14,1,1,fail
26782,1,False,13,0,13,1,1,fail
26783,1,False,13,0,13,1,1,fail
26784,1,False,17,0,17,1,1,fail
26786,1,False,1,1,2,1,1,pass
26787,1,False,13,0,13,1,1,fail
26790,1,False,6,9,15,1,1,pass
26791,1,False,36,33,69,1,1,pass
26792,1,False,54,369,423,1,1,pass
26793,1,False,31,0,31,1,1,pass
26802,1,False,2,1,3,1,1,pass
26803,2,True,42,30,72,2,2,pass
26804,1,False,68,68,136,68,2,pass
26805,1,True,18,9,27,1,1,pass
26810,1,True,0,12,12,2,2,pass
26811,1,False,10,2,12,2,2,pass
26817,1,False,6,3,9,1,1,fail
26822,1,False,1,1,2,1,1,pass
26828,1,True,1,2,3,1,1,fail
26834,2,True,13,2,15,1,1,pass
26835,1,False,14,12,26,1,1,pass
26837,1,False,1,0,1,1,1,fail
26839,1,True,1,1,2,1,1,fail
26840,1,True,8,4,12,1,1,fail
26841,2,False,28,6,34,5,3,pass
26846,2,True,143,5,148,3,1,fail
26847,1,True,1,1,2,1,1,fail
26850,2,False,12,0,12,1,1,pass
26852,1,False,12,0,12,1,1,pass
26853,2,False,3,1,4,2,2,pass
26855,1,False,3,1,4,2,2,pass
26856,1,True,3,0,3,1,1,pass
26858,1,False,1,1,2,1,1,pass
26859,1,False,129,100,229,2,2,pass
26860,1,False,1,1,2,1,1,pass
26861,1,False,31,16,47,1,1,fail
26871,1,False,116,34,150,1,1,pass
26872,1,False,4,4,8,1,1,pass
26875,1,False,25,3,28,1,1,pass
26877,2,True,2,0,2,1,1,pass
26878,1,True,2,0,2,1,1,pass
26879,2,True,49,2,51,4,1,pass
26880,1,True,49,2,51,4,1,pass
26881,1,False,1,0,1,1,1,pass
26882,2,True,229,1,230,6,1,pass
26883,1,True,229,1,230,6,1,pass
26884,1,False,24,5,29,1,1,pass
26885,1,True,155,74,229,14,3,pass
26886,1,False,0,13,13,1,1,pass
26887,1,True,4,1,5,1,1,fail
26890,1,False,13,0,13,1,1,fail
26891,1,False,2,2,4,2,2,pass
26892,2,True,120,0,120,6,1,pass
26893,1,True,56,6,62,3,1,pass
26895,2,False,1,8,9,1,1,pass
26898,2,False,26331,26310,52641,7,2,pass
26899,1,False,2,2,4,1,1,pass
26900,1,False,5,5,10,3,1,fail
26901,1,False,1,1,2,1,1,pass
26902,1,False,147,1,148,3,2,pass
26906,1,False,12,0,12,1,1,pass
26911,2,False,5,6,11,3,2,pass
26913,1,False,1,3,4,1,1,pass
26914,1,False,1,1,2,1,1,pass
26916,1,False,1,1,2,1,1,pass
26917,1,False,1,1,2,1,1,pass
26918,1,False,1,0,1,1,1,pass
26919,1,False,0,627,627,9,2,pass
26920,1,False,8,9,17,1,1,pass
26921,1,False,1,1,2,1,1,pass
26922,2,True,66,1,67,1,1,pass
26923,1,True,66,1,67,1,1,pass
26924,1,False,1,1,2,1,1,pass
26926,2,True,1,1,2,1,1,pass
26927,2,True,1,1,2,1,1,pass
26928,1,False,3,1,4,1,1,pass
26929,1,False,20,8,28,2,2,fail
26930,1,False,2,1,3,1,1,pass
26931,1,False,2,2,4,1,1,fail
26932,1,True,1,1,2,1,1,fail
26933,1,True,1,1,2,1,1,fail
26934,1,False,2,2,4,2,1,fail
26935,1,False,8,20,28,2,2,fail
26936,1,False,1,1,2,1,1,fail
26937,1,False,2,1,3,1,1,fail
26938,2,True,20,8,28,2,2,fail
26939,1,True,1,0,1,1,1,fail
26940,1,True,14,0,14,1,1,fail
26941,1,False,1,1,2,1,1,pass
26942,2,True,1,1,2,1,1,pass
26945,1,True,1,1,2,1,1,fail
26946,2,True,1,1,2,1,1,pass
26947,1,False,9,9,18,1,1,pass
26950,1,True,1,1,2,1,1,fail
26951,1,False,108,26567,26675,7,2,pass
26952,2,True,26567,108,26675,7,2,fail
26953,2,True,789,82,871,32,7,fail
26956,1,False,1,1,2,1,1,pass
26957,1,False,2,2,4,2,2,pass
26958,2,True,1,1,2,1,1,pass
26959,1,True,1,1,2,1,1,fail
26960,2,True,1,1,2,1,1,pass
26961,1,True,1,1,2,1,1,fail
26962,1,False,24,0,24,2,1,pass
26963,1,False,9,1,10,1,1,pass
26964,2,True,122,0,122,2,1,fail
26965,1,False,1,1,2,1,1,pass
26966,1,True,45,0,45,1,1,fail
26967,2,True,24,3,27,4,1,pass
26968,1,True,4,3,7,2,1,fail
26970,1,False,6,16,22,1,1,pass
26971,1,False,2,2,4,1,1,pass
26972,1,False,1,0,1,1,1,pass
26973,1,False,96,27,123,1,1,pass
26974,2,True,416,2,418,10,2,fail
26975,1,True,106,0,106,1,1,fail
26979,1,False,1,0,1,1,1,pass
26980,2,True,39,1,40,1,1,pass
26981,1,True,39,1,40,1,1,fail
26982,1,False,7,8,15,1,1,pass
26986,1,False,20,0,20,1,1,pass
26988,2,False,52,30,82,7,4,pass
26990,2,True,2,1,3,1,1,pass
26991,1,True,2,1,3,1,1,fail
26992,1,False,2,1,3,1,1,pass
26993,1,False,1,0,1,1,1,pass
26994,2,True,10,0,10,1,1,fail
26995,1,True,6,9,15,1,1,fail
26996,1,True,13,0,13,1,1,fail
26997,1,False,0,3,3,1,1,pass
26998,2,True,2,2,4,2,2,pass
26999,1,True,2,2,4,2,2,fail
27000,2,False,257,72,329,30,7,pass
27002,1,False,5,0,5,1,1,pass
27006,1,False,13,0,13,1,1,pass
27007,1,False,1,1,2,1,1,pass
27008,1,False,1,1,2,1,1,pass
27009,2,True,124,2,126,7,1,pass
27010,1,True,55,0,55,4,1,fail
27014,1,False,1,0,1,1,1,pass
27015,1,False,1,1,2,1,1,pass
27016,1,False,36,0,36,1,1,pass
27017,2,True,9,12,21,1,1,pass
27018,1,True,9,12,21,1,1,fail
27019,1,False,12,0,12,1,1,pass
27022,1,False,1,0,1,1,1,pass
27023,2,True,1,1,2,1,1,pass
27024,1,True,1,1,2,1,1,fail
27025,2,True,6,3,9,1,1,pass
27026,1,True,6,3,9,1,1,fail
27027,1,False,4,3,7,4,3,pass
27029,1,False,1,1,2,1,1,pass
27030,1,False,1,1,2,1,1,pass
27031,1,False,1,1,2,1,1,pass
27032,1,False,1,1,2,1,1,pass
27033,1,False,6,14,20,1,1,pass
27034,2,True,3,1,4,1,1,pass
27035,1,True,3,1,4,1,1,fail
27036,2,True,2,2,4,1,1,pass
27037,1,True,2,2,4,1,1,fail
27038,1,False,3,3,6,1,1,pass
27039,2,False,35,3,38,1,1,pass
27041,1,False,35,3,38,1,1,pass
27042,1,False,3,0,3,1,1,pass
27044,2,False,1620,1976,3596,78,3,fail
27047,1,False,14,1,15,2,1,pass
27049,2,True,213,45,258,6,1,pass
27050,1,True,1,0,1,1,1,fail
27052,1,False,7,2,9,1,1,pass
27055,1,False,6,9,15,1,1,pass
27056,1,False,5,7,12,1,1,pass
27057,1,False,1,1,2,1,1,pass
27058,1,False,1,1,2,1,1,pass
27060,1,False,0,4,4,1,1,pass
27061,1,False,4,0,4,1,1,pass
27062,1,False,1,1,2,1,1,pass
27063,1,False,5,4,9,1,1,pass
27068,1,False,16,16,32,4,1,pass
27069,1,False,2,2,4,1,1,pass
27070,1,False,9,5,14,1,1,pass
27071,1,False,3,3,6,1,1,pass
27072,1,False,16,7,23,1,1,pass
27073,1,False,6,0,6,1,1,pass
27078,1,False,171,0,171,1,1,pass
27079,1,False,1,0,1,1,1,pass
27080,1,False,36,46,82,1,1,pass
27082,1,False,72,133,205,1,1,pass
27084,1,False,0,129,129,7,1,fail
27090,1,False,34,74,108,1,1,pass
27096,1,False,1,1,2,1,1,pass
27099,1,False,93,95,188,2,1,pass
27100,1,False,2,2,4,1,1,pass
27110,1,False,47,38,85,2,1,pass
27111,1,False,82,200,282,3,1,pass
27113,1,False,3,2,5,1,1,pass
27120,2,True,1,1,2,1,1,pass
27121,1,True,1,1,2,1,1,fail
27122,1,False,52,72,124,1,1,pass
27133,1,False,102,74,176,1,1,pass
27138,1,False,0,3,3,1,1,pass
27139,1,False,0,1,1,1,1,pass
27140,1,False,1,1,2,1,1,pass
27141,1,False,34,15,49,4,1,pass
27142,1,False,12,11,23,4,1,pass
27144,1,False,12,18,30,1,1,fail
27145,1,False,17,0,17,1,1,pass
27146,1,False,2,2,4,13,1,pass
27148,1,False,1,1,2,2,2,pass
27150,1,False,56,71,127,1,1,pass
27151,1,False,49,74,123,4,1,pass
27153,1,False,44,117,161,1,1,pass
27156,1,False,85,86,171,1,1,pass
27159,1,False,62,23,85,1,1,pass
27160,1,False,13,13,26,4,1,pass
27161,1,False,1,1,2,7,1,pass
27163,1,False,0,18,18,1,1,pass
27167,1,False,86,91,177,1,1,pass
27169,1,False,1,1,2,1,1,pass
27170,1,False,0,0,0,1,1,fail
27171,1,False,0,11,11,1,1,fail
27175,2,False,103,49,152,15,2,pass
27177,2,True,1,1,2,1,1,pass
27178,1,True,1,1,2,1,1,fail
27180,1,False,56,20,76,13,1,pass
27182,1,False,3,0,3,1,1,pass
27188,2,False,4,4,8,1,1,pass
27190,1,False,4,4,8,1,1,pass
27191,1,False,19,0,19,1,1,pass
27193,1,False,12,0,12,1,1,fail
27194,1,False,2,2,4,2,2,fail
27198,2,True,63,1,64,1,1,pass
27199,1,False,2,2,4,2,2,pass
27200,1,False,12,12,24,1,1,fail
27205,1,False,2,0,2,1,1,pass
27206,1,False,1,0,1,1,1,pass
27207,1,False,1,2,3,1,1,pass
27208,1,False,0,372,372,4,1,fail
27211,1,False,1,1,2,1,1,pass
27218,1,False,7,0,7,1,1,pass
27219,1,False,198,0,198,1,1,pass
27222,1,False,8,3,11,1,1,pass
27223,1,False,194,0,194,6,1,pass
27230,1,False,103,0,103,2,1,pass
27232,1,False,48,98,146,1,1,pass
27243,1,False,14,0,14,1,1,pass
27251,1,False,53,38,91,1,1,pass
27253,1,False,4,2,6,1,1,pass
27254,1,False,1,1,2,1,1,pass
27256,1,False,3,3,6,1,1,pass
27257,1,False,418,1783,2201,1,1,pass
27258,1,False,12,117,129,7,4,pass
27260,2,False,117,12,129,7,4,pass
27262,1,False,1,3,4,1,1,pass
27263,1,False,2,2,4,1,1,pass
27264,2,True,116,9,125,6,3,pass
27265,1,False,13,15,28,2,2,pass
27267,1,False,4,4,8,2,2,pass
27268,1,False,115,0,115,4,2,pass
27273,1,False,18,22,40,2,2,pass
27278,2,True,1,1,2,1,1,pass
27279,1,True,1,1,2,1,1,fail
27280,1,False,1,1,2,1,1,pass
27281,1,True,12,7,19,1,1,fail
27284,1,True,6,0,6,1,1,fail
27286,2,True,20206,3064505,3084711,300,30,fail
27288,1,True,61,3,64,1,1,fail
27290,1,True,1,1,2,1,1,fail
27291,1,False,8,8,16,4,3,fail
27292,2,False,0,0,0,0,0,pass
27293,2,True,2,1,3,1,1,pass
27294,1,True,2,1,3,1,1,fail
27295,1,False,1,1,2,1,1,pass
27296,1,False,1,0,1,1,1,pass
27297,1,False,1,2,3,1,1,pass
27298,1,False,29,3,32,1,1,pass
27299,1,False,1,1,2,1,1,pass
27300,1,False,1,1,2,1,1,pass
27301,2,False,1946,497,2443,45,8,pass
27303,2,True,58,0,58,1,1,pass
27304,1,False,1,0,1,1,1,pass
27305,2,True,1091,0,1091,11,2,fail
27306,2,True,54,215,269,1,1,fail
27308,1,False,1,1,2,1,1,pass
27309,1,False,1,1,2,1,1,pass
27310,1,False,14,12,26,5,1,pass
27312,1,True,54,215,269,1,1,fail
27313,1,True,8,1,9,4,1,fail
27314,1,True,6,6,12,1,1,fail
27315,1,True,29,42,71,7,3,fail
27316,1,False,7,7,14,1,1,pass
27319,1,False,1,3,4,1,1,pass
27320,1,False,76,26,102,1,1,pass
27323,1,True,0,18,18,1,1,fail
27324,1,True,76,0,76,1,1,fail
27325,2,True,1,1,2,1,1,pass
27326,1,True,1,1,2,1,1,fail
27327,1,True,6,6,12,1,1,fail
27331,1,False,33,0,33,1,1,pass
27333,1,False,126,126,252,1,1,pass
27339,2,True,68,0,68,1,1,pass
27340,1,False,22,3,25,1,1,pass
27343,2,False,7088,3047775,3054863,184,17,pass
27346,2,True,5,2,7,1,1,pass
27347,1,True,5,2,7,1,1,fail
27350,2,True,1,0,1,1,1,pass
27351,1,True,1,0,1,1,1,fail
27352,1,True,68,0,68,1,1,fail
27353,1,False,1,0,1,1,1,pass
27354,2,True,190,1,191,6,2,fail
27355,1,True,190,1,191,6,2,fail
27356,1,False,14,8,22,1,1,pass
27357,1,False,10,5,15,1,1,pass
27359,1,False,1,1,2,1,1,pass
27361,1,False,0,2,2,1,1,pass
27362,1,False,1,0,1,1,1,fail
27363,2,False,621,6,627,5,3,fail
27366,1,False,40,3,43,1,1,pass
27367,1,False,470,1,471,2,2,pass
27371,2,False,2,2,4,1,1,pass
27373,2,False,1,1,2,1,1,pass
27375,2,False,9,4,13,1,1,pass
27377,1,False,3,1,4,1,1,pass
27378,1,False,2,1,3,1,1,fail
27379,1,False,5,3,8,1,1,fail
27380,1,False,4,0,4,1,1,fail
27381,2,False,4,0,4,1,1,fail
27384,1,False,4,0,4,1,1,pass
27385,1,False,5,3,8,1,1,pass
27386,1,False,1,1,2,1,1,fail
27387,1,False,1,1,2,1,1,fail
27388,1,False,13,13,26,1,1,fail
27389,1,False,212,150,362,4,1,fail
27393,2,True,4591,3047801,3052392,114,10,fail
27394,1,True,10,4,14,1,1,fail
27398,2,True,798,941,1739,24,1,fail
27399,1,True,1,0,1,1,1,fail
27400,2,True,11,4,15,4,2,fail
27411,1,True,12,4,16,3,1,fail
27413,1,True,778,763,1541,4,1,fail
27414,1,True,41,0,41,1,1,fail
27421,2,True,1,2,3,1,1,fail
27423,1,True,1,1,2,1,1,fail
27425,1,True,0,229,229,1,1,fail
27427,1,True,57,57,114,1,1,fail
27429,1,True,34,5,39,1,1,fail
27432,1,True,0,2,2,1,1,fail
27434,1,True,1,1,2,1,1,fail
27436,1,True,1,1,2,1,1,fail
27437,1,True,16,16,32,1,1,fail
27438,1,True,1,0,1,1,1,fail
27439,1,True,92,279,371,2,1,fail
27441,1,False,4,0,4,1,1,pass
27442,2,True,433,3,436,7,2,pass
27443,1,True,17,17,34,1,1,fail
27444,1,True,2,0,2,1,1,fail
27450,1,True,10,0,10,1,1,fail
27451,1,True,0,10,10,1,1,fail
27452,1,True,10,0,10,1,1,fail
27453,2,True,1,1,2,1,1,pass
27454,1,True,1,1,2,1,1,fail
27455,1,False,1,1,2,1,1,pass
27456,1,True,107,0,107,1,1,fail
27459,2,True,22,0,22,1,1,pass
27460,1,True,1,1,2,1,1,fail
27461,1,True,22,0,22,1,1,fail
27462,2,True,30,13,43,2,1,pass
27463,1,True,30,13,43,2,1,fail
27464,2,True,0,1,1,1,1,pass
27465,1,True,0,1,1,1,1,fail
27466,1,False,6,0,6,1,1,fail
27467,2,True,1,0,1,1,1,fail
27468,1,True,1,0,1,1,1,fail
27471,2,True,1,1,2,1,1,pass
27472,1,True,1,1,2,1,1,fail
27473,1,True,59,0,59,1,1,fail
27474,1,True,39,350,389,2,1,fail
27475,1,True,0,293,293,2,1,fail
27476,1,True,0,1514277,1514277,12,5,fail
27477,1,True,81,0,81,1,1,fail
27478,1,True,39,350,389,2,1,fail
27479,1,True,78,0,78,1,1,fail
27481,1,True,430,359,789,2,1,fail
27487,1,True,96,30,126,4,1,fail
27491,1,True,0,2,2,1,1,fail
27492,1,True,217,51,268,1,1,fail
27495,1,True,575,1428,2003,1,1,fail
27498,2,True,1,0,1,1,1,fail
27512,1,False,1,1,2,1,1,pass
27513,1,False,33,3,36,1,1,pass
27514,1,False,1,1,2,1,1,pass
27515,2,False,1,1,2,1,1,pass
27517,2,True,1,1,2,1,1,pass
27518,1,True,1,1,2,1,1,fail
27523,2,False,133,160,293,13,4,pass
27525,2,True,3,3,6,1,1,pass
27526,1,True,3,3,6,1,1,fail
27527,1,False,6,9,15,2,1,pass
27528,1,False,14,6,20,1,1,pass
27529,1,False,1,0,1,1,1,pass
27530,1,False,49,107,156,1,1,pass
27531,1,False,4,0,4,1,1,fail
27533,1,False,2,2,4,1,1,fail
27536,2,False,28,32,60,2,1,fail
27546,1,False,27,27,54,2,1,fail
27547,1,False,11,15,26,1,1,fail
27548,1,False,48,0,48,1,1,fail
27551,2,False,361,6,367,9,5,pass
27554,1,False,298,1,299,2,2,pass
27557,1,False,1,0,1,1,1,pass
27558,1,False,6,0,6,1,1,pass
27560,1,True,132,0,132,2,1,pass
27563,1,True,27,11,38,1,1,pass
27564,1,True,10,3,13,1,1,pass
27566,2,True,37,4,41,3,1,pass
27567,1,True,6,3,9,1,1,fail
27568,1,True,32,2,34,3,1,fail
27569,1,False,1,0,1,1,1,pass
27571,1,False,5,1,6,1,1,pass
27572,1,False,1,1,2,1,1,pass
27574,2,True,1,1,2,1,1,pass
27575,1,True,1,1,2,1,1,fail
27576,1,False,2,1,3,1,1,pass
27577,1,False,3,2,5,1,1,fail
27578,2,True,54,12,66,6,3,fail
27581,2,True,3,2,5,2,1,pass
27582,1,True,2,1,3,1,1,fail
27583,1,True,1,1,2,1,1,fail
27584,2,True,1,4,5,1,1,pass
27585,1,False,14,0,14,1,1,pass
27586,2,False,1983,1906,3889,9,3,pass
27589,1,True,1,4,5,1,1,fail
27590,1,True,1,1,2,1,1,fail
27592,2,True,8,8,16,5,1,fail
27593,2,True,1,1,2,1,1,pass
27594,2,True,7,7,14,4,1,pass
27595,1,True,1,1,2,1,1,fail
27596,1,True,7,7,14,4,1,fail
27597,1,True,33,0,33,2,2,fail
27598,1,True,0,1,1,1,1,fail
27600,2,True,1,1,2,1,1,pass
27601,1,True,1,1,2,1,1,fail
27602,1,True,20,10,30,3,1,fail
27603,1,False,1896,1896,3792,1,1,pass
27605,2,True,72,1,73,1,1,pass
27606,1,True,2,2,4,1,1,fail
27607,2,True,1,0,1,1,1,pass
27608,1,True,1,0,1,1,1,fail
27609,1,False,10,2,12,1,1,pass
27610,1,False,86,0,86,3,1,pass
27611,1,False,288,0,288,4,1,pass
27613,1,False,10,13,23,1,1,pass
27614,1,True,72,1,73,1,1,fail
27615,1,False,30,19,49,1,1,pass
27617,1,False,307,0,307,1,1,pass
27619,2,True,1,1,2,1,1,pass
27620,1,True,1,1,2,1,1,fail
27621,2,True,1,1,2,1,1,pass
27622,1,True,1,1,2,1,1,fail
27623,1,False,39,4,43,1,1,pass
27624,1,False,8,5,13,1,1,pass
27626,1,False,1,0,1,1,1,pass
27627,2,True,0,1,1,1,1,pass
27628,2,True,1,0,1,1,1,pass
27629,2,True,1,1,2,1,1,pass
27630,1,True,1,1,2,1,1,fail
27631,1,False,2,0,2,1,1,pass
27632,2,True,9,1,10,1,1,pass
27633,1,True,8,0,8,1,1,fail
27636,2,False,9,8,17,1,1,pass
27638,2,True,9,8,17,1,1,pass
27639,1,True,7,6,13,1,1,fail
27641,1,False,190,0,190,1,1,pass
27642,1,True,0,1,1,1,1,fail
27643,1,False,70,30,100,3,1,pass
27644,2,True,7,3,10,2,1,pass
27645,1,True,1,0,1,1,1,fail
27647,2,True,3,2,5,1,1,pass
27648,1,True,3,2,5,1,1,fail
27649,1,False,14,1,15,1,1,pass
27650,1,True,1,0,1,1,1,fail
27651,1,False,3,1,4,1,1,pass
27653,2,False,565,22,587,22,6,fail
27655,1,False,1,0,1,1,1,pass
27656,2,True,8,1,9,2,2,pass
27657,1,True,7,0,7,1,1,fail
27658,1,False,2,2,4,1,1,pass
27659,1,False,5,0,5,1,1,pass
27660,1,False,2,2,4,1,1,pass
27661,1,False,392,0,392,4,1,pass
27662,1,False,2,3,5,1,1,pass
27663,1,False,107,0,107,1,1,pass
27665,1,False,1,0,1,1,1,pass
27666,2,True,15,8,23,2,2,pass
27667,1,True,8,8,16,1,1,fail
27669,1,False,4,0,4,1,1,pass
27670,1,False,5,0,5,1,1,pass
27671,1,False,2,2,4,1,1,pass
27672,1,False,4,3,7,1,1,pass
27673,1,False,8,8,16,4,1,pass
27678,1,False,5,0,5,1,1,pass
27680,1,False,2,2,4,1,1,pass
27682,1,False,34,0,34,1,1,pass
27683,1,False,10,4,14,1,1,pass
27684,2,False,374,2,376,3,2,fail
27686,1,False,374,2,376,3,2,pass
27687,1,False,9,3,12,1,1,pass
27689,1,False,1,1,2,1,1,pass
27690,1,False,1,1,2,1,1,pass
27691,1,False,24,3,27,1,1,pass
27692,1,False,1,0,1,1,1,pass
27693,1,False,1,1,2,1,1,pass
27694,2,False,16,16,32,7,4,pass
27696,1,False,1,1,2,1,1,pass
27697,1,False,5,6,11,4,2,pass
27699,2,True,5,5,10,1,1,pass
27700,1,True,5,5,10,1,1,fail
27701,1,False,6,0,6,1,1,pass
27702,1,False,2,2,4,1,1,pass
27703,1,False,4,5,9,1,1,pass
27704,1,False,1,1,2,1,1,pass
27705,2,False,89,13113,13202,140,21,fail
27709,1,False,0,0,0,17,1,pass
27714,2,True,1,1,2,1,1,pass
27715,1,True,1,1,2,1,1,fail
27716,1,False,34,7,41,1,1,pass
27718,1,False,7,1,8,3,2,pass
27719,1,False,4,1,5,1,1,pass
27722,1,False,0,13068,13068,112,15,pass
27724,1,False,6,0,6,1,1,pass
27726,2,False,10,11,21,1,1,pass
27727,1,False,1,0,1,1,1,pass
27729,1,False,9,11,20,1,1,pass
27730,1,False,1,2,3,1,1,pass
27733,2,False,256,1,257,3,3,fail
27737,1,False,255,0,255,2,2,fail
27739,2,False,1,1,2,1,1,fail
27741,1,False,1,1,2,1,1,fail
27742,2,False,150,10,160,2,2,fail
27760,1,False,11,10,21,1,1,pass
27761,1,False,2,0,2,1,1,pass
27762,1,False,137,0,137,1,1,pass
27763,2,False,54,18,72,9,5,pass
27765,1,False,2,2,4,2,2,pass
27766,1,False,1,1,2,1,1,pass
27767,1,False,28,0,28,2,2,pass
27769,1,False,1,0,1,1,1,pass
27771,1,False,15,8,23,1,1,pass
27772,1,False,1,1,2,1,1,pass
27773,1,False,3,3,6,1,1,pass
27774,1,False,1,1,2,1,1,pass
27775,1,False,0,0,0,1,1,pass
27776,1,False,1,1,2,1,1,fail
27783,1,False,1,1,2,1,1,pass
27784,1,False,6,0,6,1,1,pass
27785,1,False,1,1,2,1,1,pass
27786,1,False,15,20,35,1,1,pass
27787,1,False,1,1,2,1,1,pass
27788,2,False,91,70,161,5,4,pass
27789,1,False,38,33,71,1,1,pass
27791,1,False,3,3,6,1,1,pass
27792,1,False,56,40,96,1,1,pass
27793,1,False,1,1,2,1,1,pass
27796,1,False,0,461,461,4,2,pass
27798,1,False,77,0,77,1,1,pass
27799,1,False,21,0,21,1,1,pass
27801,2,False,6251,4039,10290,125,10,pass
27802,1,False,18,18,36,1,1,pass
27803,1,False,22,0,22,1,1,pass
27804,1,False,1,1,2,1,1,pass
27808,1,False,14,18,32,1,1,pass
27809,1,False,20,17,37,1,1,pass
27810,1,False,1,1,2,1,1,pass
27811,1,False,2,6,8,1,1,pass
27813,1,False,0,203,203,2,1,pass
27814,1,False,0,2,2,1,1,pass
27815,1,False,6174,3790,9964,119,9,pass
27816,2,True,15,0,15,1,1,pass
27817,1,True,1,1,2,1,1,fail
27821,1,False,6,0,6,1,1,pass
27823,1,False,16,0,16,1,1,pass
27824,2,True,0,0,0,0,0,fail
27831,2,False,30,0,30,1,1,pass
27837,2,True,30,0,30,1,1,pass
27838,1,True,14,14,28,1,1,fail
27840,2,False,1,1,2,1,1,pass
27842,2,True,1,1,2,1,1,fail
27843,1,True,1,1,2,1,1,fail
27844,2,False,1,1,2,1,1,fail
27847,2,True,1,1,2,1,1,pass
27848,1,True,1,1,2,1,1,fail
27849,2,False,129,85,214,8,3,pass
27851,1,False,4,4,8,1,1,pass
27852,1,False,4,2,6,1,1,fail
27853,1,False,55,28,83,1,1,fail
27855,2,True,25,12,37,2,1,pass
27856,1,True,25,12,37,2,1,fail
27857,2,True,2,2,4,2,1,pass
27858,1,True,2,2,4,2,1,fail
27859,1,False,3,1,4,2,2,pass
27863,2,False,573,805,1378,44,9,pass
27865,1,False,1,1,2,1,1,pass
27866,1,False,1,1,2,1,1,fail
27867,1,False,2,1,3,1,1,fail
27868,1,False,1,1,2,1,1,fail
27869,1,False,1,1,2,1,1,fail
27870,1,False,1,1,2,1,1,fail
27871,1,False,8,8,16,1,1,fail
27872,1,False,4,1,5,1,1,pass
27873,1,False,3,1,4,1,1,pass
27875,1,False,1,1,2,1,1,pass
27876,2,False,20,3,23,1,1,pass
27878,1,False,2,2,4,1,1,pass
27879,1,False,19,2,21,1,1,pass
27880,1,False,1,1,2,1,1,pass
27881,1,False,28,2,30,3,1,fail
27885,1,False,4,0,4,1,1,fail
27889,1,False,1,1,2,1,1,fail
27891,1,False,1,1,2,1,1,fail
27894,2,False,19,1,20,2,2,fail
27899,2,True,14,1,15,1,1,pass
27900,1,True,13,0,13,1,1,fail
27902,2,True,5,0,5,1,1,pass
27903,1,True,5,0,5,1,1,fail
27904,1,False,12,0,12,1,1,pass
27905,2,False,167,761,928,20,7,pass
27907,1,False,6,35,41,1,1,pass
27911,1,False,0,14,14,1,1,pass
27912,1,False,20,16,36,2,2,pass
27913,1,False,9,8,17,1,1,pass
27921,2,False,20,9,29,3,2,pass
27923,2,True,2,1,3,1,1,pass
27924,1,True,2,1,3,1,1,fail
27925,1,False,2,2,4,1,1,pass
27926,2,False,11,17,28,6,2,pass
27928,1,False,7,13,20,3,2,pass
27930,1,False,1,1,2,1,1,pass
27932,1,False,32,21,53,3,2,pass
27933,2,False,3,3,6,1,1,pass
27935,2,True,3,3,6,1,1,pass
27936,1,True,3,3,6,1,1,fail
27937,1,False,1,1,2,1,1,pass
27938,2,False,3,3,6,1,1,pass
27940,2,True,3,3,6,1,1,fail
27941,1,False,3,2,5,1,1,fail
27942,1,True,3,3,6,1,1,fail
27943,1,False,9,3,12,1,1,pass
27944,1,False,7,3,10,1,1,pass
27945,1,False,10,12,22,1,1,pass
27946,2,False,1,1,2,1,1,pass
27948,1,False,1,1,2,1,1,pass
27949,2,False,1,6,7,1,1,pass
27950,1,False,1,6,7,1,1,pass
27952,1,False,7,2,9,1,1,pass
27953,1,False,1,1,2,1,1,pass
27954,1,False,3,2,5,1,1,pass
27955,1,False,44,22,66,4,2,fail
27957,1,False,1,0,1,1,1,pass
27958,1,False,0,3,3,1,1,fail
27959,1,False,12,4,16,1,1,pass
27962,1,False,1,1,2,1,1,pass
27963,1,False,5,0,5,1,1,pass
27964,1,False,1,1,2,1,1,fail
27965,2,False,1,12,13,1,1,pass
27967,1,False,1,1,2,1,1,fail
27968,1,False,0,11,11,1,1,fail
27969,1,False,0,1,1,1,1,pass
27970,2,False,331,65,396,9,6,fail
27972,1,False,19,17,36,1,1,fail
27973,1,False,2,2,4,1,1,fail
27974,1,False,54,38,92,1,1,fail
27975,1,False,2,2,4,1,1,fail
27978,1,False,7,4,11,1,1,fail
27979,1,False,6,3,9,1,1,fail
27980,1,False,3,1,4,1,1,fail
27981,1,False,1,0,1,1,1,fail
27982,2,False,9,3828,3837,40,6,pass
27984,1,False,9,3828,3837,40,6,fail
27985,2,False,13,4,17,1,1,fail
27987,1,False,3,2,5,1,1,fail
27988,1,False,1,1,2,1,1,pass
27989,1,False,1,1,2,1,1,pass
27990,1,False,2,2,4,1,1,pass
27991,1,False,6,36,42,1,1,pass
27992,1,False,8,3,11,2,1,pass
27993,1,False,3,1,4,1,1,pass
27994,1,False,1,1,2,1,1,pass
27996,1,False,0,1,1,1,1,pass
27997,1,False,6,10,16,1,1,pass
28001,1,False,0,3,3,1,1,fail
28002,1,False,91,92,183,1,1,fail
28005,1,False,7,7,14,1,1,pass
28007,1,False,2,12,14,1,1,fail
28011,2,False,37,37,74,4,1,pass
28018,1,False,1,1,2,1,1,pass
28022,1,False,1,0,1,1,1,pass
28023,1,False,4,5,9,1,1,fail
28024,1,False,5,15,20,2,1,pass
28025,1,False,0,136,136,2,1,pass
28026,1,False,4,3,7,1,1,pass
28027,2,True,10,2,12,1,1,pass
28028,1,False,2,0,2,1,1,pass
28031,1,True,7,2,9,1,1,pass
28032,1,True,1,0,1,1,1,pass
28033,1,True,63,0,63,2,1,fail
28034,1,False,6,0,6,1,1,pass
28039,1,False,81,0,81,1,1,pass
28045,1,False,4,4,8,1,1,pass
28046,1,False,1,1,2,1,1,fail
28052,1,True,10,2,12,1,1,fail
28053,1,False,1,0,1,1,1,pass
28054,1,False,5,0,5,1,1,pass
28056,1,False,1,0,1,1,1,pass
28058,1,False,4,0,4,1,1,pass
28059,1,False,6,0,6,1,1,fail
28060,1,False,14,0,14,1,1,pass
28061,1,False,3,3,6,1,1,pass
28064,1,False,3,3,6,1,1,fail
28065,1,False,20,0,20,1,1,pass
28066,1,False,0,0,0,1,1,pass
28069,1,False,0,1,1,1,1,pass
28070,1,False,2,1,3,1,1,fail
28071,1,False,2,0,2,1,1,fail
28073,1,False,1,1,2,1,1,fail
28074,1,False,0,4,4,1,1,fail
28075,1,False,2,0,2,1,1,fail
28076,1,False,28,10,38,1,1,fail
28081,1,False,2,2,4,1,1,fail
28082,1,False,1,1,2,1,1,fail
28083,1,False,2,2,4,1,1,fail
28084,1,False,2,2,4,1,1,fail
28085,1,False,2,2,4,1,1,fail
28086,1,False,2,1,3,1,1,fail
28087,1,False,2,2,4,1,1,fail
28088,1,False,1,1,2,1,1,fail
28089,1,False,10,2,12,2,2,fail
28090,1,False,15,9,24,1,1,pass
28091,1,False,57,0,57,2,2,pass
28092,1,False,9,0,9,4,1,pass
28093,1,False,0,1,1,1,1,pass
28095,1,False,2,2,4,1,1,pass
28096,1,False,1,0,1,1,1,fail
28097,1,False,2,0,2,1,1,fail
28098,1,False,2,2,4,2,2,fail
28099,1,False,1,0,1,1,1,fail
28100,1,False,1,1,2,1,1,fail
28101,1,False,0,0,0,1,1,fail
28102,1,False,1,1,2,1,1,fail
28103,1,False,23,11,34,2,2,fail
28105,1,False,1,0,1,1,1,fail
28106,1,False,11,2,13,1,1,pass
28110,1,False,4,4,8,1,1,pass
28111,1,False,3,0,3,1,1,pass
28112,1,False,3,5,8,1,1,pass
28113,1,False,1,0,1,1,1,pass
28117,1,False,7,6,13,1,1,fail
28118,1,False,7,8,15,1,1,fail
28119,1,False,1,0,1,1,1,fail
28129,1,False,1,0,1,1,1,pass
28131,2,False,2573,407,2980,60,7,pass
28133,1,False,2573,407,2980,60,7,fail
28134,2,False,322,44,366,1,1,fail
28147,1,False,2,0,2,1,1,fail
28161,1,False,18,9,27,1,1,fail
28162,1,False,6,6,12,1,1,fail
28163,1,False,313,44,357,1,1,fail
28164,1,False,127,48,175,6,2,fail
28165,1,False,1,1,2,1,1,pass
28166,1,False,181,76,257,1,1,fail
28167,1,False,1,0,1,1,1,pass
28168,1,False,14,5,19,1,1,fail
28169,1,False,3,1,4,1,1,fail
28170,1,False,8,2,10,2,2,fail
28171,1,False,5,0,5,1,1,pass
28172,1,False,7,5,12,1,1,pass
28173,1,False,3,3,6,1,1,fail
28174,1,False,9,9,18,1,1,fail
28175,1,False,2,3,5,1,1,fail
28180,1,False,13,0,13,2,2,pass
28182,1,False,2,2,4,1,1,pass
28183,1,False,9,3,12,1,1,pass
28184,1,False,3,2,5,1,1,fail
28185,1,False,1,4,5,1,1,fail
28186,1,False,4,1,5,1,1,fail
28187,1,False,1,1,2,1,1,fail
28188,1,False,18,5,23,3,2,fail
28189,1,False,49,14,63,2,1,fail
28190,1,False,2,2,4,1,1,pass
28191,1,False,1670,0,1670,1,1,fail
28192,1,False,43,50,93,3,1,fail
28193,1,False,104,75,179,8,3,fail
28195,1,False,4,4,8,2,1,pass
28197,1,False,10,3,13,1,1,fail
28198,1,False,4,0,4,1,1,fail
28199,1,False,2,1,3,1,1,fail
28200,1,False,2,0,2,1,1,fail
28201,1,False,10,11,21,2,2,fail
28202,1,False,5,1,6,1,1,fail
28203,1,False,1,1,2,1,1,fail
28204,1,False,219,140,359,17,3,fail
28207,1,False,9,3,12,1,1,pass
28209,1,False,10,2,12,1,1,pass
28213,1,False,1,1,2,1,1,pass
28214,1,False,1,1,2,1,1,fail
28215,1,False,1,0,1,1,1,fail
28216,1,False,1,1,2,1,1,fail
28217,1,False,0,14,14,1,1,fail
28219,1,False,258,90,348,6,3,fail
28223,2,True,5,4,9,1,1,pass
28224,1,True,5,4,9,1,1,pass
28225,2,True,4,4,8,1,1,pass
28226,2,True,1,1,2,1,1,pass
28227,1,True,4,4,8,1,1,pass
28228,2,True,1,1,2,1,1,pass
28229,1,True,1,1,2,1,1,pass
28230,1,True,1,1,2,1,1,pass
28231,2,True,1,1,2,1,1,pass
28232,1,True,1,1,2,1,1,pass
28234,1,False,11,3,14,1,1,pass
28235,1,False,3,1,4,1,1,pass
28236,1,False,1,0,1,1,1,pass
28237,1,False,8,1,9,1,1,pass
28239,2,False,1,1,2,1,1,pass
28241,2,True,1,1,2,1,1,pass
28242,1,True,1,1,2,1,1,pass
28243,2,True,1,1,2,1,1,pass
28244,1,True,1,1,2,1,1,fail
28245,2,True,1,1,2,1,1,fail
28246,2,True,1,1,2,1,1,fail
28248,1,False,1,1,2,1,1,pass
28249,1,False,8,0,8,2,2,pass
28252,1,False,15,1,16,1,1,pass
28253,1,False,16,0,16,3,2,pass
28254,1,False,2,2,4,1,1,pass
28255,1,False,1,1,2,1,1,pass
28256,1,False,3,3,6,1,1,fail
28257,2,False,3,3,6,2,2,fail
28259,1,False,2,2,4,1,1,pass
28260,1,False,1,1,2,1,1,pass
28261,1,False,4,1,5,2,1,pass
28262,1,False,25,0,25,1,1,pass
28264,2,False,40,39,79,1,1,pass
28267,1,False,40,39,79,1,1,pass
28268,1,False,7,2,9,1,1,pass
28269,1,False,16,2,18,1,1,pass
28270,1,False,32,0,32,1,1,pass
28271,1,False,10,0,10,1,1,pass
28272,2,False,240,34,274,8,2,pass
28276,2,True,239,33,272,8,2,pass
28277,1,True,2,1,3,1,1,pass
28280,1,False,1,1,2,1,1,pass
28282,1,False,1,0,1,1,1,pass
28285,1,False,1,1,2,1,1,pass
28286,2,True,8,2,10,2,1,pass
28287,1,True,0,4,4,1,1,pass
28289,1,False,7,7,14,1,1,pass
28293,2,True,3,3,6,1,1,pass
28294,1,True,1,1,2,1,1,pass
28295,2,False,48,93,141,1,1,pass
28299,1,False,48,164,212,2,1,pass
28302,1,False,88,0,88,1,1,pass
28303,1,False,0,1,1,1,1,pass
28304,1,False,1,0,1,1,1,pass
28305,1,False,0,2,2,1,1,pass
28306,1,False,266,0,266,2,2,pass
28307,2,False,3,76,79,1,1,pass
28311,2,True,157,19,176,3,2,pass
28312,1,True,0,3,3,2,1,pass
28313,1,True,106,19,125,3,2,fail
28317,1,True,14,13,27,1,1,pass
28318,1,True,0,16,16,1,1,fail
28320,1,False,109,41,150,5,2,pass
28321,2,False,28,0,28,1,1,pass
28325,1,False,1,1,2,1,1,pass
28328,1,False,9,1,10,1,1,pass
28329,1,False,1,1,2,1,1,pass
28330,2,True,250,30,280,7,3,fail
28331,1,True,0,25,25,2,2,fail
28332,1,False,3,3,6,1,1,fail
28333,1,False,8,0,8,2,2,fail
28334,2,False,21,15,36,9,2,fail
28337,1,True,276,31,307,7,3,pass
28339,1,False,2,2,4,2,1,pass
28340,1,False,4,4,8,1,1,fail
28341,1,False,6,5,11,3,1,fail
28342,1,False,4,3,7,3,2,pass
28343,1,False,5,1,6,1,1,pass
28344,1,False,39,2,41,2,2,pass
28345,2,True,30646,4948,35594,300,23,pass
28346,2,True,1,1,2,1,1,pass
28347,1,True,1,1,2,1,1,pass
28348,1,False,9,4,13,4,3,pass
28349,2,False,1,1,2,1,1,fail
28351,1,False,1,1,2,1,1,fail
28352,1,False,2,2,4,1,1,fail
28353,1,False,2,2,4,1,1,fail
28354,1,False,1,0,1,1,1,fail
28355,2,True,227,161,388,15,3,fail
28356,1,False,1,1,2,1,1,pass
28357,1,False,30,31,61,1,1,fail
28358,2,False,30215,4629,34844,296,20,fail
28360,1,False,0,4,4,1,1,pass
28361,1,False,2,2,4,2,1,pass
28363,1,False,1,1,2,1,1,pass
28364,1,False,30210,4620,34830,294,18,pass
28366,1,False,6,8,14,1,1,pass
28367,2,False,484,113,597,19,5,pass
28373,2,True,45,42,87,2,2,pass
28374,1,True,3,3,6,1,1,pass
28375,2,True,89,61,150,8,2,pass
28376,1,True,9,9,18,2,1,pass
28377,1,True,0,1,1,1,1,pass
28378,1,True,43,34,77,6,2,pass
28379,2,True,167,1,168,5,3,pass
28380,2,True,183,9,192,4,3,pass
28381,1,True,3,1,4,1,1,pass
28382,1,True,42,41,83,2,2,pass
28383,1,True,8,8,16,3,1,fail
28384,2,True,11,11,22,4,3,pass
28387,2,False,1,1,2,1,1,pass
28388,1,True,1,1,2,1,1,pass
28390,2,False,1806,709,2515,65,12,pass
28391,1,False,1,1,2,1,1,pass
28392,1,True,26,35,61,1,1,pass
28393,1,False,1,1,2,1,1,pass
28401,1,True,192,9,201,4,3,pass
28402,2,False,1,1,2,1,1,pass
28403,1,True,1,1,2,1,1,pass
28405,1,True,167,1,168,5,3,pass
28408,1,False,1,1,2,1,1,pass
28409,1,False,15,0,15,3,2,pass
28411,2,False,19,13,32,6,3,pass
28412,1,True,2,2,4,2,2,pass
28413,1,True,3,3,6,2,1,pass
28414,1,False,2,4,6,1,1,pass
28415,1,True,4,4,8,1,1,pass
28416,1,True,14,8,22,3,2,fail
28417,1,False,4,6,10,1,1,pass
28418,1,False,3,0,3,1,1,fail
28419,1,False,1,1,2,1,1,pass
28420,1,False,2,1,3,1,1,pass
28421,1,False,1,1,2,1,1,pass
28422,2,False,1687,134,1821,20,6,fail
28423,1,True,67,45,112,6,2,fail
28424,1,False,0,29,29,1,1,pass
28425,2,False,1,2,3,1,1,pass
28426,1,True,1,2,3,1,1,pass
28428,1,False,5,4,9,1,1,pass
28429,1,False,3,3,6,1,1,pass
28430,1,False,12,52,64,1,1,fail
28432,1,False,2,2,4,1,1,fail
28434,1,False,2,1,3,1,1,pass
28435,1,False,4,3,7,1,1,pass
28436,1,False,0,18,18,1,1,pass
28437,1,False,9,0,9,1,1,fail
28440,2,False,1,33,34,4,4,fail
28442,1,True,1,33,34,4,4,fail
28443,1,False,1,1,2,1,1,pass
28448,1,False,4,0,4,1,1,pass
28450,1,False,181,0,181,1,1,fail
28451,1,False,11,8,19,1,1,fail
28452,1,False,2,0,2,1,1,fail
28453,1,False,2,5,7,1,1,pass
28454,1,False,0,2,2,1,1,pass
28455,1,False,9,9,18,5,2,pass
28456,1,False,0,340,340,1,1,pass
28458,1,False,2,3,5,1,1,pass
28465,2,True,1,1,2,1,1,pass
28467,1,True,1,1,2,1,1,pass
28468,1,True,3,3,6,3,2,fail
28469,1,False,7,7,14,1,1,pass
28470,1,False,1,1,2,1,1,pass
28471,2,False,2,6,8,2,1,pass
28472,1,True,2,6,8,2,1,pass
28473,1,False,0,0,0,1,1,pass
28474,1,False,0,74,74,4,4,pass
28475,1,False,1,1,2,1,1,pass
28476,1,False,11,26,37,1,1,pass
28477,1,False,1,0,1,1,1,pass
28478,1,False,1,1,2,1,1,fail
28479,1,False,1,0,1,1,1,fail
28480,1,False,3,12,15,1,1,fail
28481,1,False,1,1,2,1,1,fail
28482,1,False,1,1,2,1,1,fail
28483,1,False,19,243,262,6,4,fail
28484,2,False,4,8,12,1,1,pass
28486,1,False,1,1,2,1,1,pass
28487,1,False,2,6,8,1,1,pass
28488,1,False,1,1,2,1,1,pass
28489,2,False,76,2,78,2,1,pass
28492,1,False,2,2,4,1,1,pass
28493,1,False,1,1,2,1,1,pass
28494,1,False,74,0,74,1,1,pass
28495,1,False,59,0,59,1,1,pass
28496,1,False,12,0,12,1,1,pass
28498,1,False,13,0,13,1,1,fail
28500,1,False,23,23,46,2,2,pass
28501,1,False,3,4,7,1,1,pass
28504,1,False,1,1,2,1,1,pass
28509,1,False,22,12,34,2,2,pass
28510,1,False,1,7,8,2,2,pass
28511,1,False,1,0,1,1,1,fail
28512,1,False,1,0,1,1,1,fail
28513,1,False,4,3,7,1,1,fail
28514,1,False,12,0,12,1,1,fail
28518,2,False,3,2,5,1,1,pass
28519,2,True,0,0,0,0,0,fail
28521,2,False,94,138,232,1,1,fail
28522,1,True,2,2,4,1,1,fail
28523,1,True,94,138,232,1,1,fail
28525,1,False,17,11,28,1,1,fail
28526,2,True,0,0,0,0,0,pass
28527,2,False,105,5,110,10,3,pass
28528,2,False,11,7,18,4,3,pass
28529,1,False,1,1,2,1,1,fail
28532,1,False,1,0,1,1,1,fail
28536,1,False,6,3,9,2,1,fail
28537,1,False,19,17,36,1,1,fail
28538,1,False,19,17,36,1,1,fail
28539,2,True,106,5,111,11,3,fail
28549,1,False,4,0,4,1,1,fail
28553,1,False,14,0,14,1,1,fail
28564,1,False,1,1,2,1,1,fail
28566,1,False,11,0,11,1,1,fail
28567,2,False,0,1,1,1,1,fail
28569,1,False,0,1,1,1,1,fail
28570,1,False,90,49,139,7,2,fail
28571,2,False,1,1,2,1,1,fail
28574,1,False,6,6,12,1,1,fail
28575,1,False,1,0,1,1,1,fail
28582,1,False,2,2,4,1,1,fail
28586,1,False,1,1,2,1,1,fail
28589,1,True,0,6,6,1,1,fail
28590,1,False,2,2,4,1,1,fail
28594,1,False,23,6,29,2,2,fail
28597,1,False,2,2,4,1,1,fail
28599,2,False,4,4,8,3,2,fail
28600,1,True,4,4,8,3,2,fail
28602,1,False,2,2,4,1,1,fail
28605,1,False,71,0,71,1,1,fail
28606,1,False,1,1,2,1,1,fail
28607,1,False,1,4,5,1,1,fail
28608,1,False,3,0,3,1,1,fail
28613,1,False,20,1,21,1,1,fail
28618,1,False,2,0,2,1,1,fail
28619,1,False,7,0,7,1,1,fail
28620,1,False,5,0,5,1,1,fail
28622,1,False,15,0,15,1,1,fail
28623,1,False,16,3,19,1,1,fail
28624,1,False,5,6,11,1,1,fail
28626,1,False,1,0,1,1,1,fail
28627,1,False,2,1,3,1,1,fail
28628,1,False,1,0,1,1,1,fail
28629,1,False,4,1,5,1,1,fail
28631,1,False,10,1,11,1,1,fail
28632,1,False,1,1,2,1,1,fail
28633,1,False,2,0,2,1,1,fail
28636,1,False,1,1,2,1,1,fail
28640,1,False,1,1,2,1,1,fail
28642,2,False,221,223,444,22,5,fail
28643,1,False,13,1,14,1,1,fail
28647,2,True,149,177,326,18,3,fail
28648,1,False,1,1,2,1,1,fail
28649,1,False,0,54,54,1,1,fail
28650,1,False,1,1,2,1,1,fail
28651,1,False,42,35,77,1,1,fail
28653,1,True,0,1,1,1,1,fail
28654,1,True,2,2,4,1,1,fail
28655,1,True,51,58,109,12,2,fail
28657,1,True,1,1,2,1,1,fail
28658,1,True,39,24,63,8,2,fail
28660,1,True,32,93,125,5,1,fail
28661,1,True,0,3,3,1,1,fail
28662,1,True,10,8,18,1,1,fail
28663,1,True,4,4,8,3,1,fail
28664,1,True,73,46,119,10,2,fail
28665,1,False,13,0,13,1,1,fail
28666,2,True,62,106,168,12,4,fail
28667,1,True,10,13,23,1,1,fail
28668,1,True,1,1,2,1,1,fail
28669,1,True,20,12,32,2,1,fail
28670,1,True,34,83,117,10,3,fail
28671,2,True,8,8,16,2,2,fail
28672,1,True,1,0,1,1,1,fail
28673,2,True,68,22,90,3,2,fail
28674,1,True,39,31,70,6,2,fail
28675,1,True,3,3,6,1,1,fail
28676,1,False,8,8,16,2,2,fail
28677,1,True,1,1,2,1,1,fail
28678,1,True,6,6,12,4,2,fail
28679,1,False,69,22,91,3,2,fail
28680,1,True,0,6,6,1,1,fail
28686,1,False,2,2,4,1,1,fail
28688,1,False,15,9,24,2,1,fail
28689,1,False,22,22,44,1,1,fail
28690,1,False,1,1,2,1,1,fail
28691,2,False,3,3,6,3,2,fail
28692,1,True,2,2,4,2,2,fail
28694,2,False,265,212,477,23,5,fail
28696,2,False,258,221,479,24,5,fail
28697,1,True,10,2,12,2,2,fail
28698,1,True,4,5,9,1,1,fail
28699,1,True,1,1,2,1,1,fail
28700,1,True,18,4,22,2,2,fail
28701,1,True,2,2,4,2,2,fail
28702,1,True,2,2,4,2,2,fail
28703,1,True,2,2,4,2,2,fail
28704,1,True,6,1,7,1,1,fail
28705,1,True,0,1,1,1,1,fail
28706,1,True,2,2,4,2,2,fail
28708,1,True,4,5,9,3,3,fail
28709,1,True,2,2,4,1,1,fail
28710,1,True,2,0,2,1,1,fail
28711,1,True,5,15,20,2,1,pass
28712,1,True,9,17,26,3,2,fail
28713,2,True,0,3,3,1,1,fail
28715,1,False,0,3,3,1,1,fail
28716,1,False,4,3,7,1,1,fail
28718,1,True,2,1,3,1,1,pass
28719,1,True,2,1,3,1,1,fail
28720,1,True,10,3,13,1,1,fail
28721,1,True,4,3,7,3,1,fail
28722,1,True,113,52,165,8,2,fail
28724,2,False,21,14,35,3,1,pass
28725,1,True,1,1,2,1,1,pass
28726,1,True,20,13,33,2,1,pass
28727,1,False,2,1,3,2,2,fail
28728,1,False,5,3,8,1,1,fail
28729,1,False,3,1,4,1,1,fail
28730,1,False,1,1,2,1,1,fail
28731,1,False,76,39,115,4,3,fail
28732,1,False,10,6,16,1,1,fail
28733,1,False,0,2,2,1,1,fail
28734,1,False,2,0,2,1,1,fail
28735,1,False,18,4,22,1,1,fail
28736,1,False,13,23,36,2,2,fail
28737,2,False,11,0,11,1,1,pass
28738,1,True,11,0,11,1,1,fail
28739,1,False,1,1,2,1,1,fail
28740,1,True,6,6,12,4,3,pass
28741,1,False,32,5,37,1,1,fail
28742,1,False,13,3,16,1,1,fail
28743,1,True,2,2,4,2,2,fail
28744,1,False,15,16,31,1,1,fail
28745,1,False,20,6,26,1,1,fail
28746,1,False,31,7,38,2,2,fail
28747,1,False,2,2,4,2,2,fail
28748,1,False,11,2,13,2,2,fail
28749,1,False,2,2,4,1,1,fail
28750,1,False,56,6,62,2,2,fail
28751,1,False,1,1,2,1,1,fail
28752,1,False,2,1,3,1,1,fail
28753,1,False,7,0,7,1,1,fail
28754,1,False,1,1,2,1,1,fail
28755,1,False,98,77,175,2,2,fail
28756,1,False,1,1,2,1,1,fail
28757,1,False,1,0,1,1,1,fail
28758,1,False,5,7,12,1,1,fail
28759,1,False,8,1,9,1,1,fail
28760,1,False,1,4,5,1,1,fail
28761,1,False,9,5,14,1,1,fail
28762,1,False,2,1,3,1,1,fail
28763,2,False,71,35,106,21,2,fail
28764,1,False,6,20,26,1,1,fail
28765,2,False,72,36,108,22,2,pass
28766,1,False,1,1,2,1,1,fail
28779,1,True,3,2,5,1,1,fail
28780,1,True,2,2,4,2,2,fail
28781,1,True,21,6,27,4,4,fail
28782,1,True,164,202,366,20,3,fail
28783,1,False,2,3,5,1,1,pass
28784,2,False,8,8,16,4,1,pass
28786,1,True,1,1,2,1,1,pass
28795,2,False,8,8,16,4,1,pass
28796,1,True,8,8,16,4,1,fail
28797,2,False,46,1347,1393,24,7,pass
28801,2,False,1,1,2,1,1,pass
28802,1,True,1,1,2,1,1,pass
28803,2,False,2,2,4,1,1,pass
28804,2,False,40,1343,1383,20,6,pass
28805,2,False,1,1,2,1,1,pass
28806,2,False,2,0,2,2,2,pass
28807,1,True,1,0,1,1,1,pass
28808,1,True,1,1,2,1,1,pass
28809,1,True,4,4,8,4,2,pass
28810,1,True,7,6,13,1,1,pass
28811,1,True,1,0,1,1,1,pass
28813,1,True,1,1,2,1,1,pass
28814,1,True,0,4,4,1,1,pass
28817,1,True,2,2,4,2,2,pass
28818,2,True,37,48,85,5,4,pass
28820,2,False,36,47,83,5,4,pass
28822,2,False,34,45,79,4,3,pass
28823,2,False,1,1,2,1,1,pass
28824,2,False,1,1,2,1,1,pass
28825,1,False,1,1,2,1,1,pass
28826,1,True,1,1,2,1,1,pass
28827,1,False,1,1,2,1,1,pass
28833,1,True,1,1,2,1,1,pass
28834,1,True,2,2,4,1,1,pass
28835,1,False,14,12,26,2,2,pass
28836,1,False,1,1,2,1,1,pass
28837,1,False,1,1,2,1,1,pass
28838,1,False,1,1,2,1,1,pass
28839,1,False,29,0,29,1,1,pass
28840,2,False,1,1,2,1,1,pass
28841,2,False,0,1,1,1,1,pass
28844,1,True,1,1,2,1,1,pass
28846,1,False,0,1,1,1,1,pass
28847,1,False,1,1,2,1,1,fail
28848,1,False,1,0,1,1,1,fail
28853,1,False,1,5,6,1,1,pass
28854,1,False,1,1,2,1,1,pass
28855,1,False,1,1,2,1,1,pass
28856,1,False,4,0,4,1,1,pass
28857,1,False,6,0,6,1,1,fail
28858,1,False,0,157,157,2,1,fail
28859,1,False,6,11,17,2,1,fail
28860,1,False,4,13,17,1,1,fail
28861,1,False,4,5,9,1,1,fail
28862,1,False,6,3,9,1,1,fail
28863,1,False,1,1,2,1,1,fail
28864,1,False,1,1,2,1,1,fail
28865,1,False,1,1,2,1,1,fail
28866,1,False,1,1,2,1,1,fail
28867,1,False,4,4,8,1,1,fail
28869,1,False,0,2,2,1,1,fail
28875,1,False,1,1,2,1,1,fail
28876,1,False,5,4,9,2,1,fail
28877,1,False,1,0,1,1,1,fail
28878,1,False,3,2,5,1,1,fail
28879,2,False,13,97,110,5,2,fail
28880,1,False,5,2,7,1,1,fail
28881,1,False,1,1,2,1,1,fail
28886,1,False,153,140,293,9,3,fail
28896,1,False,3,3,6,1,1,pass
28899,1,False,1,1,2,1,1,pass
28900,1,False,1,1,2,1,1,fail
28902,1,False,2,2,4,1,1,pass
28903,1,False,60,60,120,8,2,pass
28910,1,False,2,1,3,1,1,pass
28911,1,False,1,1,2,1,1,fail
28912,2,False,4,1,5,3,2,fail
28913,1,False,1,1,2,1,1,fail
28914,1,False,2,0,2,1,1,fail
28917,1,False,4,1,5,2,1,fail
28918,1,False,10,1,11,1,1,fail
28919,2,False,1,0,1,1,1,fail
28920,2,False,9,5,14,2,1,fail
28923,2,False,16,3,19,2,2,fail
28924,1,False,1,2,3,1,1,fail
28929,1,False,19,18,37,1,1,pass
28933,2,False,118,8,126,4,2,pass
28934,2,False,118,8,126,4,2,pass
28938,1,True,118,8,126,4,2,pass
28940,1,False,5,5,10,2,2,pass
28941,1,False,22,14,36,1,1,pass
28942,1,False,263,0,263,2,1,pass
28943,2,False,340,0,340,1,1,pass
28945,1,False,340,0,340,1,1,pass
28946,2,False,3,6,9,2,2,pass
28948,2,False,1,5,6,1,1,pass
28949,1,True,1,5,6,1,1,pass
28950,1,False,2,1,3,1,1,pass
28951,1,False,1,1,2,1,1,pass
28952,1,False,1,1,2,1,1,fail
28953,1,False,1,1,2,1,1,fail
28954,1,False,1,1,2,1,1,fail
28955,1,False,4,4,8,1,1,fail
28956,1,False,0,1,1,1,1,pass
28957,1,False,24,1,25,1,1,pass
28960,2,False,17,414,431,7,6,pass
28961,1,True,1,1,2,1,1,pass
28962,1,True,4,0,4,1,1,pass
28972,2,False,2,2,4,1,1,pass
28973,1,False,1,1,2,1,1,pass
28981,1,False,0,52,52,1,1,pass
28982,2,False,130,40,170,17,5,pass
28986,2,False,40,4,44,4,3,pass
28991,1,True,2,2,4,1,1,pass
28992,1,True,40,4,44,4,3,pass
28993,1,False,1,1,2,1,1,pass
28994,1,False,2,0,2,1,1,pass
28998,2,False,27,28,55,2,1,pass
28999,1,False,3,2,5,1,1,pass
29000,2,False,55,30,85,7,4,pass
29001,2,False,24,26,50,1,1,pass
29003,2,False,19,4,23,3,3,pass
29004,2,False,12,0,12,3,1,pass
29005,1,False,2,1,3,1,1,pass
29009,1,True,3,3,6,1,1,pass
29015,1,True,12,0,12,3,1,pass
29016,1,True,18,18,36,1,1,pass
29023,1,True,4,2,6,1,1,pass
29024,1,True,19,23,42,1,1,pass
29025,2,False,273,0,273,1,1,pass
29026,1,False,273,0,273,1,1,pass
29028,1,False,0,1,1,1,1,pass
29029,1,False,1,1,2,1,1,fail
29030,2,False,2,2,4,2,1,fail
29032,2,False,99,5,104,2,2,pass
29035,1,False,99,5,104,2,2,pass
29036,1,False,14,1,15,2,2,pass
29039,1,False,1,1,2,1,1,pass
29040,2,False,269,17,286,4,2,pass
29042,2,False,269,17,286,4,2,pass
29043,1,True,269,17,286,4,2,pass
29044,1,False,1,1,2,1,1,pass
29046,1,False,3,2,5,1,1,pass
29047,1,False,44,8,52,2,2,pass
29048,1,False,5,0,5,2,2,pass
29057,1,False,4,3,7,1,1,pass
29058,1,False,2,17,19,1,1,pass
29059,1,False,1,1,2,1,1,pass
29060,1,False,2,0,2,1,1,pass
29061,1,False,10,11,21,1,1,pass
29062,1,False,1,1,2,1,1,pass
29064,1,False,1,1,2,1,1,pass
29065,1,False,6,12,18,1,1,pass
29066,1,False,1,3,4,1,1,pass
29067,1,False,2,2,4,1,1,pass
29068,1,False,2,1,3,1,1,pass
29069,1,False,2,3,5,1,1,pass
29070,2,False,554,16,570,8,6,pass
29071,1,False,37,0,37,1,1,pass
29072,1,True,1,1,2,1,1,pass
29073,1,True,5,0,5,1,1,pass
29075,1,False,2,2,4,1,1,pass
29076,1,True,1,1,2,1,1,pass
29079,1,False,2,2,4,1,1,fail
29082,1,False,9,8,17,4,1,fail
29086,1,False,5,1,6,1,1,fail
29090,1,False,0,0,0,2,1,fail
29092,1,False,2,1,3,2,2,fail
29096,1,False,16,9,25,1,1,fail
29097,1,False,4,1,5,1,1,fail
29098,1,False,1,4,5,1,1,fail
29101,1,False,2,2,4,1,1,fail
29103,1,False,2,2,4,1,1,fail
29104,1,False,3,3,6,2,1,fail
29105,1,False,1,1,2,1,1,fail
29106,1,False,1,1,2,1,1,fail
29107,2,False,198,18,216,21,3,fail
29108,1,False,2,1,3,1,1,fail
29112,1,False,1,1,2,1,1,fail
29115,1,False,4,4,8,1,1,fail
29117,1,False,1,0,1,1,1,fail
29118,1,False,2,2,4,2,1,fail
29161,1,False,1,1,2,1,1,fail
29163,1,False,25,0,25,1,1,fail
29165,1,False,50,0,50,1,1,fail
29171,1,False,1,1,2,1,1,pass
29172,1,False,1,0,1,1,1,fail
29173,1,False,88,0,88,1,1,fail
29177,1,False,132,132,264,2,2,pass
29193,1,False,3,3,6,1,1,pass
29197,1,False,0,4,4,1,1,pass
29200,2,False,102,15,117,4,2,fail
29202,2,False,102,15,117,4,2,fail
29203,2,False,35,15,50,9,2,fail
29208,2,False,7,2,9,2,1,pass
29209,2,False,1,1,2,1,1,pass
29210,2,False,0,83,83,1,1,pass
29211,1,True,1,1,2,1,1,pass
29212,1,True,6,1,7,2,1,pass
29213,1,True,0,83,83,1,1,pass
29214,1,False,1,1,2,1,1,pass
29216,1,False,1,1,2,1,1,pass
29217,1,False,2,2,4,1,1,pass
29218,1,False,0,5,5,1,1,fail
29219,1,False,0,1,1,1,1,fail
29227,1,False,3,0,3,1,1,pass
29230,1,False,2,2,4,1,1,pass
29231,1,False,14,3,17,2,2,pass
29233,2,True,534,241,775,24,7,pass
29234,1,True,1,1,2,1,1,pass
29237,1,False,2,0,2,1,1,pass
29238,1,False,1,0,1,1,1,fail
29239,1,False,4,0,4,1,1,fail
29240,1,False,1,0,1,1,1,fail
29241,1,False,1,0,1,1,1,fail
29242,1,False,3,0,3,1,1,fail
29243,1,False,2,1,3,1,1,fail
29244,1,False,9,8,17,6,1,fail
29245,1,False,1,1,2,1,1,fail
29246,2,False,96,1,97,2,2,fail
29250,2,False,1,1,2,1,1,fail
29251,1,True,1,1,2,1,1,fail
29257,2,False,96,1,97,2,2,fail
29258,1,False,151,0,151,1,1,fail
29259,1,True,95,0,95,1,1,fail
29260,1,True,1,1,2,1,1,fail
29261,1,True,2,2,4,1,1,fail
29263,1,True,38,1,39,2,2,fail
29275,1,False,94,0,94,1,1,fail
29276,1,False,59,0,59,1,1,fail
29277,1,False,19,0,19,1,1,fail
29280,1,True,2,2,4,1,1,fail
29282,1,False,2,3,5,1,1,fail
29289,1,False,7,7,14,1,1,fail
29290,1,False,11,2,13,2,2,fail
29291,2,False,225,138,363,6,4,fail
29292,1,True,0,137,137,1,1,fail
29295,1,False,0,137,137,1,1,fail
29296,1,False,7,4,11,1,1,fail
29298,2,False,247,114,361,5,5,fail
29299,2,False,1,1,2,1,1,pass
29300,1,True,151,106,257,4,4,fail
29302,1,False,2,1,3,1,1,pass
29305,1,False,8,0,8,1,1,pass
29306,1,False,20,0,20,1,1,fail
29307,1,False,133,0,133,1,1,pass
29314,2,False,30,0,30,1,1,pass
29316,2,False,30,0,30,1,1,pass
29317,1,True,30,0,30,1,1,pass
29319,1,False,1,1,2,1,1,pass
29321,1,False,6854,0,6854,58,5,pass
29323,1,False,39,35,74,1,1,pass
29325,2,False,1376,148,1524,5,3,pass
29326,1,True,1,0,1,1,1,pass
29327,1,True,1375,148,1523,4,3,pass
29328,1,False,70,0,70,1,1,pass
29329,2,False,45,16,61,9,2,pass
29331,1,False,6,3,9,1,1,pass
29332,1,True,1,1,2,1,1,pass
29335,1,False,11,0,11,1,1,pass
29338,1,False,8,0,8,2,1,fail
29339,1,False,4,0,4,1,1,pass
29340,2,False,604174,0,604174,185,50,fail
29341,1,False,604174,0,604174,185,50,fail
29343,1,False,28,0,28,3,1,fail
29344,1,False,1,1,2,1,1,pass
29345,1,False,14,12,26,1,1,pass
29346,1,False,10,1,11,1,1,pass
29348,1,False,20,0,20,1,1,pass
29350,1,False,2,2,4,1,1,pass
29351,1,False,1,1,2,1,1,pass
29358,2,False,0,0,0,0,0,pass
29360,2,False,4,0,4,1,1,pass
29361,1,False,4,0,4,1,1,pass
29364,1,False,74,1,75,4,1,pass
29367,1,False,3,3,6,1,1,pass
29368,1,False,6,6,12,1,1,pass
29369,1,False,8,1,9,1,1,fail
29370,1,False,12,0,12,1,1,fail
29375,1,False,1,1,2,1,1,pass
29377,1,False,0,1,1,1,1,pass
29378,1,False,1,1,2,1,1,fail
29379,1,False,4,1,5,1,1,fail
29380,1,False,1,1,2,1,1,fail
29381,1,False,1,1,2,1,1,fail
29383,1,False,1,0,1,1,1,fail
29390,1,False,7,8,15,2,2,fail
29394,2,False,32,30,62,8,2,fail
29398,1,False,2,1,3,1,1,fail
29403,1,False,1,1,2,1,1,fail
29416,1,False,38,14,52,1,1,fail
29417,2,False,512,647,1159,3,3,fail
29418,1,False,2080444,0,2080444,36,20,fail
29419,1,False,2079548,0,2079548,36,20,fail
29420,2,False,3740,4166,7906,99,8,fail
29430,1,False,31,0,31,1,1,fail
29439,2,False,999,2,1001,7,2,fail
29447,1,False,5,1,6,1,1,fail
29452,1,False,2,2,4,1,1,fail
29453,1,False,78,77,155,1,1,fail
29479,1,True,97,2,99,3,3,pass
29480,2,False,96,1,97,2,2,pass
29481,1,True,95,0,95,1,1,pass
29482,1,True,1,1,2,1,1,pass
29495,1,True,7,2,9,2,2,pass
29496,1,True,412,647,1059,2,2,fail
29505,1,False,186,0,186,4,1,fail
29513,1,False,3,2,5,1,1,fail
29514,1,False,21,1,22,1,1,fail
29515,1,False,1,2,3,2,2,fail
29517,1,False,1,0,1,1,1,fail
29519,1,False,8,12,20,1,1,fail
29520,1,False,2,2,4,1,1,fail
29521,1,False,1,1,2,1,1,fail
29522,1,False,18,2,20,1,1,fail
29523,1,False,1,1,2,1,1,fail
29524,1,False,2,2,4,1,1,fail
29537,1,False,1,1,2,1,1,fail
29540,1,False,1,1,2,1,1,fail
29541,1,False,107,1,108,1,1,fail
29542,1,False,1,1,2,1,1,fail
29543,1,False,10,1,11,1,1,fail
29544,1,False,1,1,2,1,1,fail
29545,1,False,0,2,2,1,1,fail
29546,1,False,1,1,2,1,1,fail
29547,1,False,65,0,65,1,1,fail
29556,1,False,147,39,186,8,3,fail
29559,1,False,104,0,104,2,2,fail
29560,1,False,1,1,2,1,1,pass
29561,1,False,1,1,2,1,1,pass
29563,1,False,1,0,1,1,1,pass
29564,1,False,1,1,2,1,1,pass
29565,1,False,6,2,8,1,1,pass
29574,1,False,2,2,4,1,1,pass
29575,1,False,4,3,7,1,1,pass
29576,1,False,1,1,2,1,1,pass
29577,1,False,21,17,38,2,1,pass
29579,1,False,9,9,18,3,1,fail
29580,1,False,1,1,2,1,1,fail
29581,1,False,1,1,2,1,1,pass
29582,2,False,5,4,9,1,1,fail
29584,1,False,5,4,9,1,1,fail
29585,1,False,1,1,2,1,1,pass
29586,1,False,2,2,4,1,1,pass
29587,1,False,6,6,12,1,1,fail
29588,1,False,20,1,21,1,1,pass
29589,1,False,2,2,4,1,1,fail
29591,1,False,2,2,4,2,2,fail
29592,1,False,31,28,59,1,1,fail
29593,1,False,28,31,59,1,1,pass
29594,1,False,1,1,2,1,1,fail
29595,1,False,2,0,2,1,1,fail
29596,1,False,3,0,3,1,1,pass
29597,1,False,2,2,4,1,1,fail
29602,1,False,2,0,2,1,1,fail
29603,1,False,48,7,55,1,1,fail
29607,1,False,1,1,2,1,1,pass
29608,1,False,2,0,2,1,1,fail
29609,1,False,1,1,2,1,1,pass
29610,1,False,2,2,4,1,1,fail
29614,1,False,0,1,1,1,1,fail
29619,1,False,1,1,2,1,1,pass
29620,1,False,1,1,2,1,1,fail
29621,1,False,3,11,14,1,1,fail
29622,1,False,9,7,16,1,1,fail
29623,1,False,1,1,2,1,1,fail
29624,1,False,14,0,14,1,1,fail
29626,1,False,4,2,6,1,1,fail
29628,1,False,1,1,2,1,1,fail
29629,1,False,4,3,7,1,1,fail
29630,1,False,2,2,4,1,1,fail
29631,1,False,19,16,35,3,3,fail
29632,1,False,1,3,4,1,1,fail
29633,2,False,7,2,9,4,3,fail
29635,1,False,2,0,2,1,1,fail
29637,2,False,4,1,5,1,1,fail
29640,2,False,28,0,28,1,1,fail
29641,1,False,28,0,28,1,1,fail
29644,1,False,27,0,27,1,1,fail
29648,1,False,1,1,2,1,1,pass
29654,1,False,7,1,8,2,1,fail
29657,1,False,1,1,2,1,1,fail
29658,1,False,1,2,3,1,1,fail
29659,1,False,1,1,2,1,1,fail
29660,1,False,11,2,13,1,1,fail
29661,1,False,1,1,2,1,1,fail
29662,1,False,1,1,2,1,1,fail
29663,1,False,3,1,4,1,1,fail
29665,1,False,1,1,2,1,1,fail
29666,1,False,1,1,2,1,1,fail
29667,1,False,316709,0,316709,1,1,fail
29668,1,False,3,3,6,1,1,fail
29671,1,False,7,5,12,1,1,fail
29672,1,False,1,1,2,1,1,fail
29673,1,False,1,1,2,1,1,fail
29674,1,False,2,5,7,1,1,fail
29675,1,False,5,1,6,1,1,fail
29676,1,False,5,1,6,1,1,fail
29677,1,False,2,2,4,1,1,fail
29678,1,False,1,1,2,1,1,fail
29679,1,False,1,1,2,1,1,fail
29680,1,False,1,0,1,1,1,fail
29681,1,False,1,0,1,1,1,fail
29682,1,False,1,1,2,1,1,fail
29683,1,False,1,1,2,1,1,fail
29684,1,False,6,5,11,1,1,fail
29687,1,False,23,0,23,1,1,fail
29700,1,False,10,5,15,1,1,fail
29701,1,False,4,3,7,1,1,fail
29702,1,False,11,16,27,1,1,fail
29709,1,False,9,11,20,1,1,fail
29710,1,False,1,1,2,1,1,fail
29711,1,False,10,12,22,1,1,fail
29712,1,False,2,4,6,1,1,fail
29713,1,False,3,3,6,1,1,fail
29715,1,False,1,1,2,1,1,fail
29716,1,False,12,1,13,1,1,fail
29717,1,False,33,39,72,2,2,fail
29718,1,False,2,0,2,1,1,fail
29725,1,False,38,11,49,1,1,fail
29736,1,False,142,46,188,16,3,fail
29737,1,False,9,7,16,2,1,fail
29750,1,False,3,10,13,1,1,fail
29791,1,False,0,15,15,1,1,fail
29793,1,False,19,9,28,1,1,fail
29794,1,False,97,0,97,1,1,fail
29795,1,False,2,6,8,1,1,fail
29828,1,False,1,1,2,1,1,fail
29833,1,False,62,21,83,2,2,fail
29838,1,False,4,2,6,1,1,fail
29843,1,False,8,9,17,1,1,pass
29844,1,False,2,2,4,1,1,pass
29845,1,False,2,2,4,1,1,pass
29846,1,False,2,2,4,1,1,pass
29847,1,False,8,1,9,1,1,pass
29848,1,False,0,2,2,1,1,pass
29849,1,False,1,1,2,1,1,pass
29850,1,False,5,2,7,1,1,pass
29852,1,False,0,5,5,2,2,fail
29853,1,False,0,1,1,1,1,pass
29854,1,False,0,42,42,2,2,pass
29884,1,False,44,1,45,2,2,pass
29892,1,False,3,3,6,1,1,pass
29893,1,False,1,4,5,1,1,pass
29894,2,False,66,94,160,3,3,pass
29897,1,False,1,1,2,1,1,pass
29898,1,False,1,0,1,1,1,pass
29901,1,False,4,9,13,3,2,pass
29906,1,False,31,32,63,1,1,pass
29909,1,False,11,8,19,1,1,pass
29913,1,False,2,2,4,2,2,fail
29915,1,False,60,92,152,2,2,pass
29917,1,False,5,1,6,1,1,pass
29918,1,False,31,30,61,4,2,pass
29919,2,False,0,1,1,1,1,pass
29927,1,False,12,8,20,2,2,pass
29929,1,False,13,8,21,1,1,pass
29930,1,False,23,15,38,1,1,pass
29931,2,False,1,1,2,1,1,pass
29943,1,False,4,4,8,1,1,pass
29944,1,False,3,3,6,2,1,pass
29947,1,False,291,7,298,5,3,pass
29948,2,False,1,1,2,1,1,pass
29954,1,False,1,1,2,1,1,pass
29955,1,False,1,1,2,1,1,pass
29957,1,False,4,2,6,1,1,pass
29959,1,False,0,323,323,2,2,pass
29964,1,False,1,0,1,1,1,pass
29965,1,False,2,0,2,1,1,pass
29966,1,False,2,2,4,1,1,pass
29967,1,False,16,6,22,1,1,pass
29968,1,False,1,1,2,1,1,pass
29969,1,False,12,15,27,4,2,pass
29971,1,False,2,3,5,1,1,pass
29982,1,False,59,0,59,1,1,pass
29984,1,False,0,3,3,1,1,pass
29988,1,False,3,2,5,1,1,pass
29991,1,False,3,0,3,1,1,pass
29992,1,False,1,1,2,1,1,pass
29995,1,False,6,0,6,1,1,pass
29996,1,False,28,1,29,2,1,pass
29997,1,False,374,0,374,2,2,pass
29998,1,False,14,5,19,2,1,pass
30000,1,False,6,28,34,1,1,pass
30001,1,False,9,0,9,1,1,pass
30007,1,False,49,47,96,3,2,pass
30008,1,False,3,1,4,1,1,pass
30017,1,False,9,12,21,2,2,pass
30036,1,False,140,78,218,3,1,pass
30041,1,False,2,3,5,1,1,pass
30042,1,False,3,2,5,1,1,fail
30043,1,False,29,3,32,3,2,fail
30044,1,False,2,2,4,1,1,fail
30045,1,False,2,3,5,1,1,fail
30046,1,False,1,2,3,1,1,fail
30047,1,False,2,1,3,1,1,fail
30048,1,False,1,1,2,1,1,fail
30049,1,False,0,3,3,1,1,fail
30050,1,False,2,5,7,1,1,fail
30052,1,False,1,1,2,1,1,fail
30056,1,False,88,60,148,1,1,fail
30057,1,False,1,2,3,1,1,fail
30058,1,False,9,2,11,1,1,fail
30059,1,False,1,1,2,1,1,fail
30060,1,False,1,1,2,1,1,fail
30068,1,False,1,1,2,1,1,fail
30071,1,False,2,2,4,1,1,fail
30072,1,False,2,2,4,1,1,fail
30073,1,False,2,2,4,1,1,fail
30074,1,False,1,1,2,1,1,fail
30075,1,False,3,3,6,1,1,fail
30076,1,False,7,0,7,1,1,fail
30092,1,False,11,5,16,1,1,fail
30097,1,False,15,2,17,1,1,fail
30102,1,False,5,10,15,1,1,fail
30104,1,False,2,76,78,1,1,fail
30108,1,False,42,17,59,2,1,fail
30109,1,False,7,0,7,2,2,fail
30112,1,False,2,0,2,1,1,fail
30113,1,False,1,1,2,1,1,fail
30120,1,False,14,14,28,2,2,fail
30121,1,False,18,19,37,2,2,fail
30123,1,False,2,2,4,1,1,fail
30124,1,False,5,3,8,1,1,fail
30132,1,False,3,7,10,1,1,fail
30135,1,False,2,2,4,1,1,fail
30143,1,False,7,6,13,1,1,fail
30147,1,False,25,21,46,1,1,fail
30148,1,False,28,8,36,1,1,fail
30149,1,False,85,67,152,4,2,fail
30151,1,False,4,0,4,1,1,fail
30158,1,False,7,3,10,1,1,fail
30161,1,False,16,0,16,1,1,fail
30205,1,False,337,0,337,1,1,fail
30206,1,False,4,6,10,1,1,fail
30228,1,False,2,2,4,1,1,fail
30229,1,False,14,12,26,2,2,fail
30231,1,False,2,2,4,2,1,fail
30232,1,False,5,2,7,1,1,fail
30233,2,False,297,226,523,94,11,fail
30240,2,False,298,227,525,94,11,fail
30241,1,True,1,0,1,1,1,fail
30242,1,True,37,3,40,24,2,fail
30251,1,False,1,1,2,1,1,fail
30253,1,False,1,1,2,1,1,fail
30255,1,False,1,1,2,1,1,fail
30256,1,False,1,1,2,1,1,fail
30260,1,False,1,3,4,1,1,fail
30264,1,False,9,12,21,1,1,fail
30265,1,False,1,1,2,1,1,fail
30266,1,False,5,1,6,2,2,fail
30271,1,False,0,1,1,1,1,fail
30272,1,False,1,1,2,1,1,fail
30273,1,False,1,0,1,1,1,fail
30275,1,False,2,5,7,1,1,fail
30276,1,False,219,0,219,1,1,fail
30296,1,False,0,1,1,1,1,fail
30306,1,False,34,0,34,1,1,fail
30308,1,False,4,0,4,1,1,fail
30311,1,False,10,5,15,1,1,fail
30404,1,False,38,0,38,3,3,fail
30406,1,False,0,1,1,1,1,fail
30409,1,False,99,0,99,2,1,fail
30412,1,False,18,0,18,1,1,fail
30413,1,True,1,1,2,1,1,pass
30414,1,False,1,1,2,1,1,pass
30420,1,False,1,1,2,1,1,fail
30421,1,False,1,1,2,1,1,fail
30422,1,False,649,0,649,5,2,fail
30424,1,False,1,1,2,1,1,fail
30427,1,False,7,0,7,1,1,fail
30428,1,False,2,1,3,1,1,pass
30429,1,False,2,2,4,1,1,fail
30430,1,False,3,5,8,1,1,fail
30431,1,False,6,3,9,1,1,pass
30432,1,False,10,7,17,1,1,fail
30433,1,False,1,1,2,1,1,pass
30434,1,False,12,28,40,2,2,pass
30435,1,False,1,1,2,1,1,fail
30438,1,False,1,1,2,1,1,pass
30444,1,False,1,1,2,1,1,pass
30447,2,False,0,0,0,0,0,pass
30451,2,False,4,0,4,1,1,fail
30452,1,False,1,1,2,1,1,fail
30458,1,False,7,0,7,1,1,pass
30460,1,False,33,0,33,1,1,pass
30461,1,False,1,1,2,1,1,pass
30465,1,False,1,1,2,1,1,pass
30466,1,False,1,1,2,1,1,pass
30467,2,False,6,0,6,1,1,fail
30476,1,True,4,0,4,1,1,fail
30484,1,False,4,2,6,1,1,pass
30485,1,False,2,0,2,1,1,pass
30486,1,False,2,0,2,1,1,fail
30487,1,False,1,1,2,1,1,fail
30488,1,False,2,7,9,1,1,pass
30493,1,False,0,2,2,1,1,pass
30496,1,False,2,0,2,1,1,fail
30497,1,False,2,2,4,1,1,fail
30501,2,False,15,5,20,1,1,fail
30503,1,False,13,7,20,1,1,fail
30504,1,False,3,1,4,1,1,fail
30505,1,False,3,1,4,1,1,fail
30506,1,False,4,1,5,1,1,fail
30507,2,False,1,0,1,1,1,fail
30510,1,False,1,0,1,1,1,fail
30511,1,False,1,1,2,1,1,fail
30517,1,False,9,11,20,2,2,fail
30518,1,False,12,5,17,1,1,fail
30522,1,False,8,3,11,1,1,fail
30533,1,False,1,1,2,1,1,fail
30534,1,False,1,1,2,1,1,fail
30535,1,False,1,0,1,1,1,fail
30537,1,False,0,1,1,1,1,fail
30539,1,False,1,0,1,1,1,fail
30542,1,False,3,3,6,1,1,fail
30543,1,False,1,1,2,1,1,fail
30544,1,False,1,0,1,1,1,fail
30545,1,False,3,2,5,1,1,fail
30546,1,False,3,2,5,1,1,fail
30575,2,False,19,1,20,1,1,pass
30584,1,False,3,1,4,1,1,pass
30585,1,False,16,0,16,1,1,pass
30586,1,False,6,10,16,1,1,pass
30595,1,False,82,0,82,1,1,pass
30598,1,False,11,16,27,1,1,pass
30599,2,False,2,2,4,1,1,pass
30600,1,True,2,2,4,1,1,pass
30601,2,False,2,2,4,1,1,pass
30602,1,True,2,2,4,1,1,pass
30603,1,False,3,1,4,1,1,pass
30604,1,False,2,2,4,1,1,pass
30605,2,False,1,0,1,1,1,pass
30606,1,True,1,0,1,1,1,fail
30607,2,False,3,1,4,1,1,pass
30610,1,False,1,1,2,1,1,pass
30611,1,False,3,1,4,1,1,pass
30613,2,False,2,2,4,1,1,pass
30614,1,True,2,2,4,1,1,pass
30617,1,False,5,5,10,1,1,pass
30624,1,False,1,1,2,1,1,pass
30630,1,False,1,1,2,1,1,pass
30631,1,False,1,1,2,1,1,fail
30633,1,False,2,1,3,1,1,fail
30655,1,False,64,10,74,6,2,fail
30665,1,False,5,0,5,1,1,fail
30681,1,False,2,2,4,2,1,fail
30700,1,False,1,1,2,1,1,pass
30702,1,False,1,1,2,1,1,pass
30704,1,False,1,1,2,1,1,pass
30705,1,False,1,1,2,1,1,pass
30707,1,False,0,1,1,1,1,pass
30708,1,False,2,2,4,1,1,fail
30709,1,False,1,1,2,1,1,fail
30712,1,False,0,1,1,1,1,pass
30714,1,False,5,0,5,1,1,fail
30715,1,False,1,1,2,1,1,fail
30719,1,False,1,1,2,1,1,fail
30720,1,False,4,4,8,1,1,fail
30721,1,False,1,2,3,1,1,fail
30723,1,False,2,2,4,1,1,fail
30724,1,False,3,1,4,1,1,fail
30725,1,False,1,1,2,1,1,fail
30727,1,False,2,2,4,1,1,fail
30733,1,False,1,1,2,1,1,fail
30735,1,False,1,1,2,1,1,fail
30738,1,False,0,1,1,1,1,fail
30739,1,False,1,1,2,1,1,fail
30743,1,False,1,1,2,1,1,fail
30744,1,False,3,2,5,1,1,fail
30745,1,False,2,1,3,1,1,fail
30746,1,False,2,2,4,1,1,fail
30748,1,False,1,1,2,1,1,fail
30753,1,False,20,3,23,2,1,fail
30755,1,False,2,2,4,1,1,fail
30756,1,False,2,1,3,1,1,fail
30757,1,False,4,3,7,1,1,fail
30760,1,False,1,0,1,1,1,fail
